"","GEO.id","GEO.id2","GEO.display.label","YEAR","HC01_VC04","HC01_VC05","HC01_VC06","HC01_VC07","HC01_VC08","HC01_VC09","HC01_VC10","HC01_VC75","HC01_VC76","HC01_VC77","HC01_VC78","HC01_VC79","HC01_VC80","HC01_VC81","HC01_VC82","HC01_VC83","HC01_VC84","HC01_VC85","HC01_VC121","HC03_VC13","HC03_VC166"
"1","1400000US11001000100",11001000100,"Census Tract 1, District of Columbia, District of Columbia","2011",4143,3032,3013,2964,49,19,1111,125,82,0,77,141,310,164,358,264,889,136842,82215,1.6,6.3
"2","1400000US11001000201",11001000201,"Census Tract 2.01, District of Columbia, District of Columbia","2011",4216,566,566,566,0,0,3650,0,0,0,0,0,0,0,0,0,0,NA,NA,0,100
"3","1400000US11001000202",11001000202,"Census Tract 2.02, District of Columbia, District of Columbia","2011",4380,2348,2341,2280,61,7,2032,157,19,24,109,63,159,110,343,272,521,135893,49553,2.6,16.3
"4","1400000US11001000300",11001000300,"Census Tract 3, District of Columbia, District of Columbia","2011",4745,3723,3703,3538,165,20,1022,93,15,170,107,252,358,253,345,396,498,99063,59320,4.5,9.7
"5","1400000US11001000400",11001000400,"Census Tract 4, District of Columbia, District of Columbia","2011",1263,923,923,903,20,0,340,23,7,8,18,52,109,0,67,56,257,182578,73438,2.2,4.7
"6","1400000US11001000501",11001000501,"Census Tract 5.01, District of Columbia, District of Columbia","2011",3238,2503,2503,2428,75,0,735,123,19,96,86,168,307,373,542,152,142,89191,54737,3,14.9
"7","1400000US11001000502",11001000502,"Census Tract 5.02, District of Columbia, District of Columbia","2011",2866,2265,2265,2229,36,0,601,18,0,46,104,229,233,172,262,276,390,104375,63134,1.6,4.4
"8","1400000US11001000600",11001000600,"Census Tract 6, District of Columbia, District of Columbia","2011",4057,2565,2565,2492,73,0,1492,139,32,45,10,176,230,269,330,171,639,113922,72946,2.8,9.2
"9","1400000US11001000701",11001000701,"Census Tract 7.01, District of Columbia, District of Columbia","2011",4212,3159,3159,3065,94,0,1053,75,26,60,218,467,496,531,545,182,400,81039,57851,3,2.1
"10","1400000US11001000702",11001000702,"Census Tract 7.02, District of Columbia, District of Columbia","2011",3381,2862,2862,2773,89,0,519,176,37,138,83,272,639,228,474,292,55,66352,49673,3.1,8
"11","1400000US11001000801",11001000801,"Census Tract 8.01, District of Columbia, District of Columbia","2011",5921,3613,3613,3369,244,0,2308,312,94,75,203,61,452,291,657,343,895,118569,61125,6.8,10.7
"12","1400000US11001000802",11001000802,"Census Tract 8.02, District of Columbia, District of Columbia","2011",2102,1451,1441,1410,31,10,651,111,0,65,80,136,174,135,174,122,355,92384,72037,2.2,8.5
"13","1400000US11001000901",11001000901,"Census Tract 9.01, District of Columbia, District of Columbia","2011",6794,2313,2313,2156,157,0,4481,61,0,36,5,19,46,45,298,120,816,219583,13546,6.8,6.5
"14","1400000US11001000902",11001000902,"Census Tract 9.02, District of Columbia, District of Columbia","2011",1644,1134,1134,1073,61,0,510,33,0,11,22,37,51,31,123,132,370,179167,79444,5.4,4.6
"15","1400000US11001001001",11001001001,"Census Tract 10.01, District of Columbia, District of Columbia","2011",6105,4086,4066,3965,101,20,2019,96,34,136,0,130,338,266,462,450,910,147500,72305,2.5,5.1
"16","1400000US11001001002",11001001002,"Census Tract 10.02, District of Columbia, District of Columbia","2011",2851,2264,2226,2159,67,38,587,231,65,33,87,111,292,185,366,292,130,89119,52567,3,16.2
"17","1400000US11001001100",11001001100,"Census Tract 11, District of Columbia, District of Columbia","2011",3734,2574,2574,2540,34,0,1160,74,18,55,56,111,130,174,364,303,519,128909,64233,1.3,6.9
"18","1400000US11001001200",11001001200,"Census Tract 12, District of Columbia, District of Columbia","2011",4568,3549,3498,3390,108,51,1019,157,6,52,101,218,334,301,319,390,590,109405,53803,3.1,7.5
"19","1400000US11001001301",11001001301,"Census Tract 13.01, District of Columbia, District of Columbia","2011",3594,2597,2597,2488,109,0,997,168,0,60,114,275,378,197,219,216,441,79098,55246,4.2,12.5
"20","1400000US11001001302",11001001302,"Census Tract 13.02, District of Columbia, District of Columbia","2011",6686,5112,5041,4862,179,71,1574,210,47,202,198,683,924,724,928,416,532,78140,62703,3.6,7.4
"21","1400000US11001001401",11001001401,"Census Tract 14.01, District of Columbia, District of Columbia","2011",2606,1956,1946,1924,22,10,650,102,30,102,54,49,143,164,121,175,493,126576,71500,1.1,4.6
"22","1400000US11001001402",11001001402,"Census Tract 14.02, District of Columbia, District of Columbia","2011",2356,1471,1462,1379,83,9,885,108,43,88,59,92,255,96,128,85,424,87826,74922,5.7,6
"23","1400000US11001001500",11001001500,"Census Tract 15, District of Columbia, District of Columbia","2011",4529,2684,2684,2666,18,0,1845,0,57,29,59,130,147,80,313,395,937,179859,106275,0.7,2
"24","1400000US11001001600",11001001600,"Census Tract 16, District of Columbia, District of Columbia","2011",3584,2319,2319,2237,82,0,1265,41,76,72,44,54,199,200,271,253,486,135403,69340,3.5,3.8
"25","1400000US11001001702",11001001702,"Census Tract 17.02, District of Columbia, District of Columbia","2011",2490,2012,2012,1782,230,0,478,26,11,49,68,121,136,112,226,259,90,106154,56147,11.4,12.1
"26","1400000US11001001803",11001001803,"Census Tract 18.03, District of Columbia, District of Columbia","2011",2555,1899,1886,1591,295,13,656,165,155,193,233,234,300,119,117,11,75,38000,27296,15.6,12.2
"27","1400000US11001001804",11001001804,"Census Tract 18.04, District of Columbia, District of Columbia","2011",3594,2464,2464,2171,293,0,1130,292,50,296,241,380,283,228,82,54,39,38007,24952,11.9,26.5
"28","1400000US11001001901",11001001901,"Census Tract 19.01, District of Columbia, District of Columbia","2011",3306,2243,2243,2044,199,0,1063,41,44,150,207,294,173,224,251,105,48,53750,35091,8.9,2.3
"29","1400000US11001001902",11001001902,"Census Tract 19.02, District of Columbia, District of Columbia","2011",1786,1100,1090,999,91,10,686,28,11,134,72,158,37,124,157,69,43,64196,31993,8.3,8.2
"30","1400000US11001002001",11001002001,"Census Tract 20.01, District of Columbia, District of Columbia","2011",2088,1585,1585,1496,89,0,503,88,35,34,212,197,131,27,87,27,165,47878,31264,5.6,7.9
"31","1400000US11001002002",11001002002,"Census Tract 20.02, District of Columbia, District of Columbia","2011",3198,2169,2169,1941,228,0,1029,138,62,111,97,168,197,162,171,127,191,56808,35059,10.5,11.8
"32","1400000US11001002101",11001002101,"Census Tract 21.01, District of Columbia, District of Columbia","2011",4157,2791,2791,2410,381,0,1366,124,149,348,182,230,291,283,218,42,23,43769,28686,13.7,18.8
"33","1400000US11001002102",11001002102,"Census Tract 21.02, District of Columbia, District of Columbia","2011",4064,2778,2769,2471,298,9,1286,236,70,134,254,383,319,235,296,65,4,45046,32423,10.8,15.8
"34","1400000US11001002201",11001002201,"Census Tract 22.01, District of Columbia, District of Columbia","2011",3027,2073,2073,1675,398,0,954,51,32,58,126,204,196,141,193,87,42,60882,27684,19.2,3.3
"35","1400000US11001002202",11001002202,"Census Tract 22.02, District of Columbia, District of Columbia","2011",2523,1625,1625,1422,203,0,898,182,25,81,181,274,201,90,90,75,79,44096,41908,12.5,13.8
"36","1400000US11001002301",11001002301,"Census Tract 23.01, District of Columbia, District of Columbia","2011",2491,1717,1717,1492,225,0,774,148,49,33,130,163,100,159,127,139,26,54167,36667,13.1,15.4
"37","1400000US11001002302",11001002302,"Census Tract 23.02, District of Columbia, District of Columbia","2011",1469,682,671,659,12,11,787,100,44,90,17,83,159,118,98,15,8,54022,45170,1.8,27.6
"38","1400000US11001002400",11001002400,"Census Tract 24, District of Columbia, District of Columbia","2011",3067,2201,2201,1820,381,0,866,79,20,120,150,168,214,154,158,100,120,63342,38371,17.3,15
"39","1400000US11001002501",11001002501,"Census Tract 25.01, District of Columbia, District of Columbia","2011",2031,1196,1196,861,335,0,835,201,114,120,67,23,80,160,68,36,99,32067,34931,28,33.8
"40","1400000US11001002502",11001002502,"Census Tract 25.02, District of Columbia, District of Columbia","2011",4249,3039,3039,2717,322,0,1210,172,178,101,357,288,347,246,202,90,60,42604,30874,10.6,13.5
"41","1400000US11001002600",11001002600,"Census Tract 26, District of Columbia, District of Columbia","2011",1917,1347,1347,1281,66,0,570,7,0,49,120,79,110,61,130,125,311,126944,65313,4.9,4.3
"42","1400000US11001002701",11001002701,"Census Tract 27.01, District of Columbia, District of Columbia","2011",4559,3937,3937,3679,258,0,622,239,54,258,182,387,519,254,350,254,159,58659,42617,6.6,12.6
"43","1400000US11001002702",11001002702,"Census Tract 27.02, District of Columbia, District of Columbia","2011",4487,3803,3803,3518,285,0,684,128,79,112,74,195,189,291,455,303,294,99524,52473,7.5,8.5
"44","1400000US11001002801",11001002801,"Census Tract 28.01, District of Columbia, District of Columbia","2011",3087,2166,2159,1915,244,7,921,247,73,119,228,357,293,193,142,60,6,46393,37299,11.3,24.7
"45","1400000US11001002802",11001002802,"Census Tract 28.02, District of Columbia, District of Columbia","2011",3710,2885,2885,2693,192,0,825,335,111,213,152,230,304,247,232,107,45,45625,33071,6.7,19.8
"46","1400000US11001002900",11001002900,"Census Tract 29, District of Columbia, District of Columbia","2011",3493,2680,2656,2445,211,24,813,49,40,159,177,185,245,172,178,114,154,60861,36513,7.9,14.8
"47","1400000US11001003000",11001003000,"Census Tract 30, District of Columbia, District of Columbia","2011",2928,2271,2256,2009,247,15,657,253,73,24,87,149,216,159,165,86,144,60459,42436,10.9,24.2
"48","1400000US11001003100",11001003100,"Census Tract 31, District of Columbia, District of Columbia","2011",2347,1750,1750,1602,148,0,597,24,52,106,65,60,160,214,86,50,108,74637,35519,8.5,6.3
"49","1400000US11001003200",11001003200,"Census Tract 32, District of Columbia, District of Columbia","2011",3840,2967,2967,2728,239,0,873,142,207,146,181,92,241,252,265,63,111,62361,30096,8.1,17.2
"50","1400000US11001003301",11001003301,"Census Tract 33.01, District of Columbia, District of Columbia","2011",2432,2000,1990,1772,218,10,432,78,22,36,52,97,241,244,140,180,151,86101,50122,11,18.5
"51","1400000US11001003302",11001003302,"Census Tract 33.02, District of Columbia, District of Columbia","2011",2024,1730,1730,1594,136,0,294,71,12,14,21,140,128,109,273,140,47,97216,48075,7.9,16.2
"52","1400000US11001003400",11001003400,"Census Tract 34, District of Columbia, District of Columbia","2011",5092,2222,2222,1931,291,0,2870,148,78,138,144,119,135,45,205,106,57,46365,11806,13.1,20.4
"53","1400000US11001003500",11001003500,"Census Tract 35, District of Columbia, District of Columbia","2011",2895,1812,1805,1545,260,7,1083,176,32,81,84,88,69,157,128,84,48,63510,23566,14.4,24.3
"54","1400000US11001003600",11001003600,"Census Tract 36, District of Columbia, District of Columbia","2011",3597,2678,2678,2541,137,0,919,204,146,104,204,311,265,138,253,59,179,47656,41875,5.1,18.2
"55","1400000US11001003700",11001003700,"Census Tract 37, District of Columbia, District of Columbia","2011",4529,3284,3284,3100,184,0,1245,313,25,218,108,303,421,338,303,147,64,60324,32015,5.6,20.2
"56","1400000US11001003800",11001003800,"Census Tract 38, District of Columbia, District of Columbia","2011",4125,3622,3603,3426,177,19,503,190,41,171,150,284,378,475,543,221,186,79120,56825,4.9,9.4
"57","1400000US11001003900",11001003900,"Census Tract 39, District of Columbia, District of Columbia","2011",4236,3602,3588,3320,268,14,634,144,34,97,121,347,608,444,512,218,231,76107,57736,7.5,5.5
"58","1400000US11001004001",11001004001,"Census Tract 40.01, District of Columbia, District of Columbia","2011",3038,2650,2650,2484,166,0,388,79,0,89,39,87,353,413,457,181,359,98425,66976,6.3,3.2
"59","1400000US11001004002",11001004002,"Census Tract 40.02, District of Columbia, District of Columbia","2011",2217,1912,1912,1889,23,0,305,66,21,57,57,99,403,173,259,245,200,89189,66759,1.2,4.8
"60","1400000US11001004100",11001004100,"Census Tract 41, District of Columbia, District of Columbia","2011",2542,2007,2007,1902,105,0,535,28,10,96,31,80,283,181,341,136,321,105341,56992,5.2,3.1
"61","1400000US11001004201",11001004201,"Census Tract 42.01, District of Columbia, District of Columbia","2011",3261,2971,2971,2886,85,0,290,121,52,51,14,215,466,302,433,145,334,89353,63344,2.9,13.3
"62","1400000US11001004202",11001004202,"Census Tract 42.02, District of Columbia, District of Columbia","2011",2390,2002,1989,1898,91,13,388,37,37,59,102,197,334,173,326,121,271,81326,65205,4.6,6.1
"63","1400000US11001004300",11001004300,"Census Tract 43, District of Columbia, District of Columbia","2011",2678,1975,1959,1848,111,16,703,200,68,143,134,193,292,215,229,150,132,64959,50917,5.7,18
"64","1400000US11001004400",11001004400,"Census Tract 44, District of Columbia, District of Columbia","2011",4787,4016,3955,3748,207,61,771,220,73,58,77,175,308,260,603,205,446,101853,60300,5.2,14.5
"65","1400000US11001004600",11001004600,"Census Tract 46, District of Columbia, District of Columbia","2011",2184,1652,1628,1536,92,24,532,66,31,21,163,130,122,205,255,81,35,78257,50120,5.7,10.4
"66","1400000US11001004701",11001004701,"Census Tract 47.01, District of Columbia, District of Columbia","2011",2375,1408,1373,1036,337,35,967,543,137,145,120,214,17,102,97,104,136,19572,40293,24.5,38.6
"67","1400000US11001004702",11001004702,"Census Tract 47.02, District of Columbia, District of Columbia","2011",1429,998,946,748,198,52,431,140,138,15,21,80,94,142,116,117,31,70490,66991,20.9,30.6
"68","1400000US11001004801",11001004801,"Census Tract 48.01, District of Columbia, District of Columbia","2011",1711,1243,1243,1164,79,0,468,34,88,91,44,78,74,222,140,97,79,82866,46667,6.4,10.8
"69","1400000US11001004802",11001004802,"Census Tract 48.02, District of Columbia, District of Columbia","2011",2664,2048,2048,1926,122,0,616,138,54,45,119,282,150,106,249,94,112,57943,46875,6,13.5
"70","1400000US11001004901",11001004901,"Census Tract 49.01, District of Columbia, District of Columbia","2011",1838,1310,1287,1181,106,23,528,140,72,160,67,65,174,111,72,65,104,50948,50041,8.2,21.3
"71","1400000US11001004902",11001004902,"Census Tract 49.02, District of Columbia, District of Columbia","2011",2575,2218,2204,2098,106,14,357,27,39,83,158,162,156,135,195,213,257,89267,44470,4.8,15
"72","1400000US11001005001",11001005001,"Census Tract 50.01, District of Columbia, District of Columbia","2011",1636,1380,1380,1302,78,0,256,22,0,27,77,43,120,58,124,118,307,135313,73951,5.7,8.9
"73","1400000US11001005002",11001005002,"Census Tract 50.02, District of Columbia, District of Columbia","2011",5601,4368,4281,4082,199,87,1233,217,220,186,190,428,286,323,896,322,394,81744,61769,4.6,9.4
"74","1400000US11001005201",11001005201,"Census Tract 52.01, District of Columbia, District of Columbia","2011",5348,4596,4576,4426,150,20,752,317,191,133,246,469,700,321,631,337,678,72340,65260,3.3,10.6
"75","1400000US11001005301",11001005301,"Census Tract 53.01, District of Columbia, District of Columbia","2011",4917,4191,4176,4080,96,15,726,153,26,143,190,302,633,470,575,436,512,93006,64127,2.3,7.9
"76","1400000US11001005500",11001005500,"Census Tract 55, District of Columbia, District of Columbia","2011",6144,4628,4559,4377,182,69,1516,340,77,200,62,240,504,608,848,218,778,94489,76576,4,14.8
"77","1400000US11001005600",11001005600,"Census Tract 56, District of Columbia, District of Columbia","2011",5445,2496,2496,2447,49,0,2949,671,145,296,112,242,399,369,534,205,444,64028,60696,2,27.1
"78","1400000US11001005800",11001005800,"Census Tract 58, District of Columbia, District of Columbia","2011",2641,2164,2120,2089,31,44,477,64,37,32,75,110,199,182,364,349,339,120329,82479,1.5,6.8
"79","1400000US11001005900",11001005900,"Census Tract 59, District of Columbia, District of Columbia","2011",3616,2388,2379,2026,353,9,1228,93,127,47,71,93,180,283,277,89,145,83911,41326,14.8,36.6
"80","1400000US11001006202",11001006202,"Census Tract 62.02, District of Columbia, District of Columbia","2011",0,0,0,0,0,0,0,0,0,0,0,0,0,0,0,0,0,NA,NA,NA,NA
"81","1400000US11001006400",11001006400,"Census Tract 64, District of Columbia, District of Columbia","2011",1337,714,714,579,135,0,623,269,88,202,67,84,101,22,56,31,0,20965,23672,18.9,33.7
"82","1400000US11001006500",11001006500,"Census Tract 65, District of Columbia, District of Columbia","2011",2268,1954,1940,1867,73,14,314,6,0,13,146,36,130,198,323,216,262,127963,72937,3.8,2.8
"83","1400000US11001006600",11001006600,"Census Tract 66, District of Columbia, District of Columbia","2011",1676,1381,1381,1356,25,0,295,30,0,21,45,102,116,84,177,118,240,123170,75404,1.8,5.7
"84","1400000US11001006700",11001006700,"Census Tract 67, District of Columbia, District of Columbia","2011",3593,2862,2827,2773,54,35,731,30,0,47,0,101,243,128,432,312,543,145313,83884,1.9,3
"85","1400000US11001006801",11001006801,"Census Tract 68.01, District of Columbia, District of Columbia","2011",1782,1390,1367,1231,136,23,392,53,28,53,49,120,70,139,179,111,35,83618,44821,9.9,12.8
"86","1400000US11001006802",11001006802,"Census Tract 68.02, District of Columbia, District of Columbia","2011",1827,1345,1341,1289,52,4,482,25,8,90,4,124,92,101,259,70,113,99500,51932,3.9,5.7
"87","1400000US11001006804",11001006804,"Census Tract 68.04, District of Columbia, District of Columbia","2011",2511,29,29,24,5,0,2482,0,0,0,0,0,0,0,0,0,0,NA,8182,17.2,100
"88","1400000US11001006900",11001006900,"Census Tract 69, District of Columbia, District of Columbia","2011",2023,1600,1564,1471,93,36,423,40,15,34,14,70,214,136,331,74,210,118500,62297,5.9,7.1
"89","1400000US11001007000",11001007000,"Census Tract 70, District of Columbia, District of Columbia","2011",2393,2004,1606,1559,47,398,389,73,19,34,8,28,144,261,187,163,240,102054,70478,2.9,6
"90","1400000US11001007100",11001007100,"Census Tract 71, District of Columbia, District of Columbia","2011",2309,1514,1514,1210,304,0,795,275,147,113,80,27,141,105,180,115,64,39861,51522,20.1,47.4
"91","1400000US11001007200",11001007200,"Census Tract 72, District of Columbia, District of Columbia","2011",1703,1247,1079,1020,59,168,456,103,35,26,75,128,66,159,228,118,34,80313,53904,5.5,10
"92","1400000US11001007301",11001007301,"Census Tract 73.01, District of Columbia, District of Columbia","2011",2037,1657,533,488,45,1124,380,0,13,15,94,105,151,173,108,17,0,66990,30969,8.4,2
"93","1400000US11001007304",11001007304,"Census Tract 73.04, District of Columbia, District of Columbia","2011",2683,1471,1471,1064,407,0,1212,233,120,219,59,98,117,91,162,70,11,32000,30417,27.7,38.1
"94","1400000US11001007401",11001007401,"Census Tract 74.01, District of Columbia, District of Columbia","2011",1590,540,540,400,140,0,1050,375,45,112,76,98,87,18,13,20,0,16000,28537,25.9,48
"95","1400000US11001007403",11001007403,"Census Tract 74.03, District of Columbia, District of Columbia","2011",2466,1453,1453,1175,278,0,1013,177,119,77,307,193,196,43,88,20,0,31647,30481,19.1,30.3
"96","1400000US11001007404",11001007404,"Census Tract 74.04, District of Columbia, District of Columbia","2011",2127,1167,1167,1000,167,0,960,212,78,216,176,156,129,66,32,37,27,26681,31088,14.3,41
"97","1400000US11001007406",11001007406,"Census Tract 74.06, District of Columbia, District of Columbia","2011",1952,1157,1157,841,316,0,795,273,63,112,105,198,129,52,48,0,0,27333,20682,27.3,45.2
"98","1400000US11001007407",11001007407,"Census Tract 74.07, District of Columbia, District of Columbia","2011",1950,1406,1406,1145,261,0,544,110,114,144,149,173,196,88,83,38,20,36332,34744,18.6,30.6
"99","1400000US11001007408",11001007408,"Census Tract 74.08, District of Columbia, District of Columbia","2011",2183,919,919,741,178,0,1264,262,133,208,129,57,159,41,21,0,17,19175,19686,19.4,50.7
"100","1400000US11001007409",11001007409,"Census Tract 74.09, District of Columbia, District of Columbia","2011",2456,1399,1399,1013,386,0,1057,427,104,196,231,201,97,140,102,0,0,25369,28986,27.6,43
"101","1400000US11001007502",11001007502,"Census Tract 75.02, District of Columbia, District of Columbia","2011",3303,1557,1557,1233,324,0,1746,394,183,149,188,373,174,77,113,6,24,31458,28375,20.8,41.7
"102","1400000US11001007503",11001007503,"Census Tract 75.03, District of Columbia, District of Columbia","2011",1777,963,955,710,245,8,814,181,87,89,105,129,131,50,45,0,0,30313,21071,25.7,43.7
"103","1400000US11001007504",11001007504,"Census Tract 75.04, District of Columbia, District of Columbia","2011",1773,972,972,896,76,0,801,208,218,178,33,139,97,146,21,0,0,19519,25536,7.8,45
"104","1400000US11001007601",11001007601,"Census Tract 76.01, District of Columbia, District of Columbia","2011",3300,1764,1749,1394,355,15,1536,303,79,151,204,444,279,147,141,29,22,40681,31169,20.3,17.2
"105","1400000US11001007603",11001007603,"Census Tract 76.03, District of Columbia, District of Columbia","2011",3438,2340,2340,2021,319,0,1098,143,32,128,357,418,358,314,202,124,21,49458,48800,13.6,15.8
"106","1400000US11001007604",11001007604,"Census Tract 76.04, District of Columbia, District of Columbia","2011",3117,1858,1858,1617,241,0,1259,202,93,267,113,147,306,247,223,74,45,51074,36690,13,17.3
"107","1400000US11001007605",11001007605,"Census Tract 76.05, District of Columbia, District of Columbia","2011",3215,1887,1887,1602,285,0,1328,245,179,160,120,334,262,228,135,22,0,41773,31622,15.1,29.9
"108","1400000US11001007703",11001007703,"Census Tract 77.03, District of Columbia, District of Columbia","2011",3800,2442,2417,2008,409,25,1358,404,261,286,253,329,250,76,219,123,4,32220,32306,16.9,26.7
"109","1400000US11001007707",11001007707,"Census Tract 77.07, District of Columbia, District of Columbia","2011",2915,1780,1780,1487,293,0,1135,79,151,149,233,245,251,148,100,35,37,46680,31453,16.5,10.9
"110","1400000US11001007708",11001007708,"Census Tract 77.08, District of Columbia, District of Columbia","2011",2018,1205,1205,925,280,0,813,256,93,105,146,201,130,107,44,23,20,29063,30708,23.2,35.5
"111","1400000US11001007709",11001007709,"Census Tract 77.09, District of Columbia, District of Columbia","2011",1420,950,950,758,192,0,470,168,137,146,151,170,100,34,69,11,15,28490,24298,20.2,18.9
"112","1400000US11001007803",11001007803,"Census Tract 78.03, District of Columbia, District of Columbia","2011",2429,1546,1546,1109,437,0,883,195,150,299,95,76,319,86,79,12,7,25577,25052,28.3,25.9
"113","1400000US11001007804",11001007804,"Census Tract 78.04, District of Columbia, District of Columbia","2011",2251,1100,1100,867,233,0,1151,185,97,185,142,117,37,113,80,53,13,26833,29075,21.2,28.9
"114","1400000US11001007806",11001007806,"Census Tract 78.06, District of Columbia, District of Columbia","2011",1807,1109,1109,852,257,0,698,150,39,114,63,199,88,130,14,22,50,42390,33214,23.2,20
"115","1400000US11001007807",11001007807,"Census Tract 78.07, District of Columbia, District of Columbia","2011",1629,931,931,778,153,0,698,187,82,142,134,136,116,18,18,11,13,26989,22907,16.4,32.9
"116","1400000US11001007808",11001007808,"Census Tract 78.08, District of Columbia, District of Columbia","2011",2554,1295,1295,917,378,0,1259,316,111,194,93,174,157,63,53,35,22,24375,26964,29.2,42.6
"117","1400000US11001007809",11001007809,"Census Tract 78.09, District of Columbia, District of Columbia","2011",1997,1022,1022,817,205,0,975,172,183,234,45,133,147,93,54,34,0,21332,19625,20.1,37.9
"118","1400000US11001007901",11001007901,"Census Tract 79.01, District of Columbia, District of Columbia","2011",2959,1907,1900,1499,401,7,1052,264,104,354,129,156,131,190,57,110,83,31765,27961,21.1,34.9
"119","1400000US11001007903",11001007903,"Census Tract 79.03, District of Columbia, District of Columbia","2011",1246,748,735,655,80,13,498,133,23,76,46,152,112,140,31,9,24,43000,42083,10.9,21.1
"120","1400000US11001008001",11001008001,"Census Tract 80.01, District of Columbia, District of Columbia","2011",2399,1882,1882,1840,42,0,517,110,48,52,33,110,91,227,224,213,139,94931,57432,2.2,12.1
"121","1400000US11001008002",11001008002,"Census Tract 80.02, District of Columbia, District of Columbia","2011",3044,2341,2304,2143,161,37,703,45,43,109,80,114,178,267,283,134,289,96385,55821,7,8.6
"122","1400000US11001008100",11001008100,"Census Tract 81, District of Columbia, District of Columbia","2011",2799,2425,2425,2355,70,0,374,27,6,30,62,50,211,105,298,143,415,128523,61958,2.9,5
"123","1400000US11001008200",11001008200,"Census Tract 82, District of Columbia, District of Columbia","2011",2475,2037,2037,1973,64,0,438,40,7,104,115,116,290,199,171,128,308,85484,54893,3.1,11.3
"124","1400000US11001008301",11001008301,"Census Tract 83.01, District of Columbia, District of Columbia","2011",2301,1936,1936,1905,31,0,365,41,10,27,60,82,129,93,197,199,282,121058,64037,1.6,10.4
"125","1400000US11001008302",11001008302,"Census Tract 83.02, District of Columbia, District of Columbia","2011",1966,1620,1591,1585,6,29,346,6,44,0,48,119,165,134,150,139,214,96823,60781,0.4,4.8
"126","1400000US11001008402",11001008402,"Census Tract 84.02, District of Columbia, District of Columbia","2011",2067,1490,1480,1274,206,10,577,82,57,111,17,180,133,121,220,80,38,64261,43246,13.9,10.8
"127","1400000US11001008410",11001008410,"Census Tract 84.10, District of Columbia, District of Columbia","2011",1130,938,938,851,87,0,192,36,0,52,8,10,49,44,199,131,0,104710,43494,9.3,8.2
"128","1400000US11001008701",11001008701,"Census Tract 87.01, District of Columbia, District of Columbia","2011",1768,1332,1332,1143,189,0,436,45,39,16,133,148,137,115,124,32,22,54750,32370,14.2,13.3
"129","1400000US11001008702",11001008702,"Census Tract 87.02, District of Columbia, District of Columbia","2011",1388,834,834,683,151,0,554,91,73,47,37,61,103,53,160,26,0,51650,47703,18.1,17
"130","1400000US11001008802",11001008802,"Census Tract 88.02, District of Columbia, District of Columbia","2011",3606,2258,2226,1776,450,32,1348,271,126,258,145,286,283,174,145,74,52,41746,37462,20.2,30.3
"131","1400000US11001008803",11001008803,"Census Tract 88.03, District of Columbia, District of Columbia","2011",1733,942,930,771,159,12,791,84,71,59,46,9,58,55,49,12,0,27344,6127,17.1,49.2
"132","1400000US11001008804",11001008804,"Census Tract 88.04, District of Columbia, District of Columbia","2011",2564,1519,1519,1234,285,0,1045,225,193,178,188,118,162,76,56,58,0,26615,21432,18.8,39.7
"133","1400000US11001008903",11001008903,"Census Tract 89.03, District of Columbia, District of Columbia","2011",2004,1526,1526,1166,360,0,478,237,118,200,192,150,209,56,18,24,6,30020,21005,23.6,24.6
"134","1400000US11001008904",11001008904,"Census Tract 89.04, District of Columbia, District of Columbia","2011",2860,1825,1814,1367,447,11,1035,345,143,256,164,158,350,65,69,39,0,27601,28438,24.6,28.3
"135","1400000US11001009000",11001009000,"Census Tract 90, District of Columbia, District of Columbia","2011",2341,1225,1225,1193,32,0,1116,419,160,167,102,91,116,177,181,127,79,32287,51804,2.6,16.8
"136","1400000US11001009102",11001009102,"Census Tract 91.02, District of Columbia, District of Columbia","2011",3639,1986,1986,1654,332,0,1653,319,147,207,156,122,363,122,128,43,5,31544,27946,16.7,30
"137","1400000US11001009201",11001009201,"Census Tract 92.01, District of Columbia, District of Columbia","2011",1277,822,822,631,191,0,455,64,20,57,95,79,82,38,55,22,13,41902,16992,23.2,21
"138","1400000US11001009203",11001009203,"Census Tract 92.03, District of Columbia, District of Columbia","2011",2636,1856,1856,1475,381,0,780,116,68,70,175,218,165,123,162,70,39,46159,34932,20.5,17.9
"139","1400000US11001009204",11001009204,"Census Tract 92.04, District of Columbia, District of Columbia","2011",2192,1280,1280,1080,200,0,912,242,149,122,145,221,233,112,26,0,16,31290,28005,15.6,22.9
"140","1400000US11001009301",11001009301,"Census Tract 93.01, District of Columbia, District of Columbia","2011",2538,1787,1780,1616,164,7,751,53,39,69,17,203,183,123,232,109,124,75833,50613,9.2,18.9
"141","1400000US11001009302",11001009302,"Census Tract 93.02, District of Columbia, District of Columbia","2011",946,644,644,609,35,0,302,0,32,4,9,70,127,78,54,24,24,65700,37614,5.4,3.1
"142","1400000US11001009400",11001009400,"Census Tract 94, District of Columbia, District of Columbia","2011",3438,2426,2426,1953,473,0,1012,108,17,155,142,124,448,265,264,168,92,69639,50425,19.5,9.8
"143","1400000US11001009501",11001009501,"Census Tract 95.01, District of Columbia, District of Columbia","2011",5150,2795,2795,2520,275,0,2355,124,153,402,127,277,345,147,155,47,19,40528,11589,9.8,25.2
"144","1400000US11001009503",11001009503,"Census Tract 95.03, District of Columbia, District of Columbia","2011",2426,1395,1395,1236,159,0,1031,82,39,58,90,118,136,195,277,123,28,77451,51146,11.4,16.1
"145","1400000US11001009504",11001009504,"Census Tract 95.04, District of Columbia, District of Columbia","2011",2589,1418,1418,1160,258,0,1171,155,7,68,185,131,290,97,147,40,34,52095,35966,18.2,14.6
"146","1400000US11001009505",11001009505,"Census Tract 95.05, District of Columbia, District of Columbia","2011",2187,1263,1263,1133,130,0,924,81,58,47,45,199,224,171,143,90,0,66591,37132,10.3,8.8
"147","1400000US11001009507",11001009507,"Census Tract 95.07, District of Columbia, District of Columbia","2011",1382,727,727,698,29,0,655,39,5,47,46,184,83,77,111,23,40,52981,40769,4,5.7
"148","1400000US11001009508",11001009508,"Census Tract 95.08, District of Columbia, District of Columbia","2011",2621,1473,1473,1335,138,0,1148,157,68,134,132,200,302,231,181,30,19,51525,39306,9.4,9.1
"149","1400000US11001009509",11001009509,"Census Tract 95.09, District of Columbia, District of Columbia","2011",2745,1762,1762,1428,334,0,983,65,23,113,89,40,322,223,297,13,23,66341,38438,19,4.7
"150","1400000US11001009601",11001009601,"Census Tract 96.01, District of Columbia, District of Columbia","2011",1533,879,879,738,141,0,654,219,65,38,12,156,174,77,92,0,7,45000,33846,16,41.3
"151","1400000US11001009602",11001009602,"Census Tract 96.02, District of Columbia, District of Columbia","2011",2004,1271,1271,1000,271,0,733,302,83,256,254,130,151,125,7,0,0,25307,26414,21.3,39.2
"152","1400000US11001009603",11001009603,"Census Tract 96.03, District of Columbia, District of Columbia","2011",2286,1490,1490,1281,209,0,796,141,79,220,153,255,292,187,79,47,8,41898,36473,14,15.3
"153","1400000US11001009604",11001009604,"Census Tract 96.04, District of Columbia, District of Columbia","2011",1755,985,985,828,157,0,770,88,120,125,54,194,248,84,50,24,10,43588,40066,15.9,15.7
"154","1400000US11001009700",11001009700,"Census Tract 97, District of Columbia, District of Columbia","2011",1963,1197,1197,875,322,0,766,164,114,93,131,90,96,99,65,36,5,30821,24728,26.9,37.4
"155","1400000US11001009801",11001009801,"Census Tract 98.01, District of Columbia, District of Columbia","2011",1022,558,558,350,208,0,464,96,49,71,84,38,89,29,9,29,0,28900,25938,37.3,47.1
"156","1400000US11001009802",11001009802,"Census Tract 98.02, District of Columbia, District of Columbia","2011",809,448,448,327,121,0,361,87,72,94,59,99,75,0,11,0,0,24464,21190,27,54.9
"157","1400000US11001009803",11001009803,"Census Tract 98.03, District of Columbia, District of Columbia","2011",1910,1051,1051,730,321,0,859,199,153,151,137,148,160,52,38,8,0,26471,32275,30.5,24.1
"158","1400000US11001009804",11001009804,"Census Tract 98.04, District of Columbia, District of Columbia","2011",2058,1329,1329,1043,286,0,729,119,0,126,128,132,265,124,75,26,16,50156,33750,21.5,24
"159","1400000US11001009807",11001009807,"Census Tract 98.07, District of Columbia, District of Columbia","2011",2795,1732,1732,1325,407,0,1063,212,92,278,168,136,460,95,108,9,0,38500,25126,23.5,27.8
"160","1400000US11001009810",11001009810,"Census Tract 98.10, District of Columbia, District of Columbia","2011",1601,1003,1003,944,59,0,598,196,110,122,250,196,76,29,14,0,0,26515,18647,5.9,34.1
"161","1400000US11001009811",11001009811,"Census Tract 98.11, District of Columbia, District of Columbia","2011",2553,1604,1604,1055,549,0,949,451,202,181,339,255,177,73,14,0,0,25750,25755,34.2,42.3
"162","1400000US11001009901",11001009901,"Census Tract 99.01, District of Columbia, District of Columbia","2011",1884,1130,1130,1030,100,0,754,27,71,37,38,54,230,291,150,38,92,80036,55496,8.8,8
"163","1400000US11001009902",11001009902,"Census Tract 99.02, District of Columbia, District of Columbia","2011",2276,1420,1420,1099,321,0,856,92,80,170,65,137,233,190,111,41,28,52379,37600,22.6,25.7
"164","1400000US11001009903",11001009903,"Census Tract 99.03, District of Columbia, District of Columbia","2011",1113,726,717,615,102,9,387,97,12,25,6,85,259,82,0,42,0,54667,31930,14.2,22.4
"165","1400000US11001009904",11001009904,"Census Tract 99.04, District of Columbia, District of Columbia","2011",1265,875,875,691,184,0,390,88,76,79,87,164,78,84,40,0,0,37931,26250,21,27.8
"166","1400000US11001009905",11001009905,"Census Tract 99.05, District of Columbia, District of Columbia","2011",1902,1275,1275,971,304,0,627,181,43,70,226,117,278,106,59,0,15,36185,36822,23.8,20.7
"167","1400000US11001009906",11001009906,"Census Tract 99.06, District of Columbia, District of Columbia","2011",1280,826,826,694,132,0,454,53,72,40,133,152,112,56,47,0,0,40085,34103,16,14.8
"168","1400000US11001009907",11001009907,"Census Tract 99.07, District of Columbia, District of Columbia","2011",1732,1074,1074,847,227,0,658,319,74,164,98,199,78,95,37,12,9,24459,26636,21.1,42.3
"169","1400000US11001010100",11001010100,"Census Tract 101, District of Columbia, District of Columbia","2011",2380,1867,1855,1810,45,12,513,207,58,73,102,307,275,253,169,125,155,56771,55536,2.4,14.9
"170","1400000US11001010200",11001010200,"Census Tract 102, District of Columbia, District of Columbia","2011",2399,1799,1785,1704,81,14,600,85,14,77,144,110,338,286,213,118,220,76414,66213,4.5,9.4
"171","1400000US11001010300",11001010300,"Census Tract 103, District of Columbia, District of Columbia","2011",3087,2207,2124,1771,353,83,880,73,43,92,119,105,341,75,128,103,50,55910,29701,16.6,14.2
"172","1400000US11001010400",11001010400,"Census Tract 104, District of Columbia, District of Columbia","2011",3266,2156,2156,1650,506,0,1110,211,100,353,120,202,250,227,41,14,0,29873,27090,23.5,30.6
"173","1400000US11001010500",11001010500,"Census Tract 105, District of Columbia, District of Columbia","2011",3802,2956,2940,2750,190,16,846,352,101,187,111,225,434,355,248,175,211,59583,54529,6.5,18.2
"174","1400000US11001010600",11001010600,"Census Tract 106, District of Columbia, District of Columbia","2011",3513,2699,2699,2463,236,0,814,128,37,111,158,112,228,230,297,202,88,76680,40602,8.7,16
"175","1400000US11001010700",11001010700,"Census Tract 107, District of Columbia, District of Columbia","2011",2086,1500,1500,1425,75,0,586,280,38,27,58,115,211,202,163,79,124,59522,45757,5,28.3
"176","1400000US11001010800",11001010800,"Census Tract 108, District of Columbia, District of Columbia","2011",6431,1340,1340,1260,80,0,5091,403,134,69,18,80,115,90,81,11,5,13672,3283,6,59.7
"177","1400000US11001010900",11001010900,"Census Tract 109, District of Columbia, District of Columbia","2011",2355,1236,1236,982,254,0,1119,215,117,103,181,154,183,102,34,39,0,29667,28245,20.6,52.9
"178","1400000US11001011000",11001011000,"Census Tract 110, District of Columbia, District of Columbia","2011",3532,2224,2127,1935,192,97,1308,128,128,137,106,334,366,307,599,121,150,74500,58969,9,18.3
"179","1400000US11001011100",11001011100,"Census Tract 111, District of Columbia, District of Columbia","2011",3881,2297,2297,1863,434,0,1584,108,124,134,86,195,297,238,244,128,97,60268,47144,18.9,13.2
"180","1400000US11001000100",11001000100,"Census Tract 1, District of Columbia, District of Columbia","2012",4263,3233,3211,3112,99,22,1030,95,75,27,50,148,322,230,336,269,901,134712,73786,3.1,5.9
"181","1400000US11001000201",11001000201,"Census Tract 2.01, District of Columbia, District of Columbia","2012",4074,754,754,683,71,0,3320,0,0,0,0,0,0,0,0,0,0,NA,NA,9.4,100
"182","1400000US11001000202",11001000202,"Census Tract 2.02, District of Columbia, District of Columbia","2012",4566,2549,2544,2462,82,5,2017,219,17,25,108,84,176,48,345,249,563,141603,48902,3.2,20.7
"183","1400000US11001000300",11001000300,"Census Tract 3, District of Columbia, District of Columbia","2012",4695,3618,3603,3482,121,15,1077,73,0,194,111,231,331,269,308,340,609,105500,64576,3.4,9.8
"184","1400000US11001000400",11001000400,"Census Tract 4, District of Columbia, District of Columbia","2012",1285,905,905,886,19,0,380,19,6,14,4,37,73,15,67,76,301,195938,89440,2.1,7
"185","1400000US11001000501",11001000501,"Census Tract 5.01, District of Columbia, District of Columbia","2012",3052,2501,2501,2394,107,0,551,114,0,169,84,248,305,251,506,153,158,80900,52841,4.3,9.1
"186","1400000US11001000502",11001000502,"Census Tract 5.02, District of Columbia, District of Columbia","2012",2750,2135,2135,2085,50,0,615,27,0,51,120,174,243,136,253,238,420,108182,62344,2.3,4.6
"187","1400000US11001000600",11001000600,"Census Tract 6, District of Columbia, District of Columbia","2012",3977,2604,2604,2516,88,0,1373,111,33,34,26,109,245,293,380,238,601,120045,79614,3.4,8
"188","1400000US11001000701",11001000701,"Census Tract 7.01, District of Columbia, District of Columbia","2012",4149,3096,3096,2967,129,0,1053,103,28,52,309,437,365,485,623,146,410,82379,56773,4.2,2.7
"189","1400000US11001000702",11001000702,"Census Tract 7.02, District of Columbia, District of Columbia","2012",3090,2466,2466,2370,96,0,624,224,54,164,74,157,757,256,363,164,57,64113,50241,3.9,11
"190","1400000US11001000801",11001000801,"Census Tract 8.01, District of Columbia, District of Columbia","2012",6119,3632,3632,3370,262,0,2487,296,78,21,228,81,454,230,571,370,1008,120313,62182,7.2,12
"191","1400000US11001000802",11001000802,"Census Tract 8.02, District of Columbia, District of Columbia","2012",2109,1393,1379,1327,52,14,716,114,7,72,70,89,128,147,174,155,361,115230,78409,3.8,9.6
"192","1400000US11001000901",11001000901,"Census Tract 9.01, District of Columbia, District of Columbia","2012",6805,2475,2475,2249,226,0,4330,87,17,48,8,31,74,66,230,124,814,221771,12583,9.1,10.8
"193","1400000US11001000902",11001000902,"Census Tract 9.02, District of Columbia, District of Columbia","2012",1687,1185,1185,1129,56,0,502,17,0,10,21,37,68,43,106,138,378,184583,88804,4.7,3.3
"194","1400000US11001001001",11001001001,"Census Tract 10.01, District of Columbia, District of Columbia","2012",6354,4292,4275,4168,107,17,2062,48,0,87,29,144,288,263,413,511,1046,161450,75635,2.5,4.8
"195","1400000US11001001002",11001001002,"Census Tract 10.02, District of Columbia, District of Columbia","2012",3008,2459,2415,2341,74,44,549,236,40,43,94,114,255,150,381,265,195,91455,52539,3.1,19.2
"196","1400000US11001001100",11001001100,"Census Tract 11, District of Columbia, District of Columbia","2012",3602,2416,2416,2366,50,0,1186,57,14,58,62,159,101,164,472,212,597,121250,78699,2.1,5.4
"197","1400000US11001001200",11001001200,"Census Tract 12, District of Columbia, District of Columbia","2012",4551,3417,3388,3305,83,29,1134,144,6,32,96,172,385,299,368,376,594,108125,61034,2.4,6.6
"198","1400000US11001001301",11001001301,"Census Tract 13.01, District of Columbia, District of Columbia","2012",3626,2751,2751,2589,162,0,875,131,0,49,133,265,332,189,242,207,461,83594,52489,5.9,10.9
"199","1400000US11001001302",11001001302,"Census Tract 13.02, District of Columbia, District of Columbia","2012",7234,5716,5688,5531,157,28,1518,201,56,197,114,390,1232,652,977,532,565,84758,61081,2.8,7.4
"200","1400000US11001001401",11001001401,"Census Tract 14.01, District of Columbia, District of Columbia","2012",2711,1950,1932,1872,60,18,761,119,22,96,37,75,134,127,132,140,552,124500,82500,3.1,8
"201","1400000US11001001402",11001001402,"Census Tract 14.02, District of Columbia, District of Columbia","2012",2410,1592,1573,1490,83,19,818,114,28,81,71,44,197,161,121,119,448,94444,81447,5.3,9.2
"202","1400000US11001001500",11001001500,"Census Tract 15, District of Columbia, District of Columbia","2012",4576,2895,2895,2854,41,0,1681,10,58,14,58,106,109,83,300,342,1007,193233,100775,1.4,2.9
"203","1400000US11001001600",11001001600,"Census Tract 16, District of Columbia, District of Columbia","2012",3498,2256,2256,2097,159,0,1242,20,63,64,42,46,205,201,305,193,493,130786,73400,7,3.6
"204","1400000US11001001702",11001001702,"Census Tract 17.02, District of Columbia, District of Columbia","2012",2472,1959,1959,1728,231,0,513,45,16,50,74,117,155,133,216,209,143,98981,53920,11.8,14
"205","1400000US11001001803",11001001803,"Census Tract 18.03, District of Columbia, District of Columbia","2012",2708,1898,1889,1652,237,9,810,132,147,143,235,282,319,109,121,33,87,42206,27248,12.5,9.7
"206","1400000US11001001804",11001001804,"Census Tract 18.04, District of Columbia, District of Columbia","2012",4106,2669,2669,2380,289,0,1437,296,52,259,246,319,352,149,132,43,51,38597,24646,10.8,27.7
"207","1400000US11001001901",11001001901,"Census Tract 19.01, District of Columbia, District of Columbia","2012",3280,2244,2244,2023,221,0,1036,87,19,155,169,194,185,259,257,111,41,64279,36449,9.8,6.8
"208","1400000US11001001902",11001001902,"Census Tract 19.02, District of Columbia, District of Columbia","2012",1839,1155,1142,1052,90,13,684,29,5,145,65,130,70,107,154,65,69,66976,39961,7.9,8.7
"209","1400000US11001002001",11001002001,"Census Tract 20.01, District of Columbia, District of Columbia","2012",1981,1458,1458,1320,138,0,523,74,41,43,162,193,108,24,126,28,162,47862,33388,9.5,6.2
"210","1400000US11001002002",11001002002,"Census Tract 20.02, District of Columbia, District of Columbia","2012",3142,2186,2186,1907,279,0,956,165,52,154,69,138,314,172,171,103,134,57821,35845,12.8,12.2
"211","1400000US11001002101",11001002101,"Census Tract 21.01, District of Columbia, District of Columbia","2012",4430,3054,3054,2648,406,0,1376,96,114,348,183,202,339,239,342,77,33,55705,33217,13.3,18.1
"212","1400000US11001002102",11001002102,"Census Tract 21.02, District of Columbia, District of Columbia","2012",3957,2808,2791,2528,263,17,1149,264,78,118,238,401,371,182,311,61,22,45385,34601,9.4,19.2
"213","1400000US11001002201",11001002201,"Census Tract 22.01, District of Columbia, District of Columbia","2012",3006,2016,2016,1601,415,0,990,65,21,47,86,204,195,154,139,71,70,66071,32265,20.6,6.2
"214","1400000US11001002202",11001002202,"Census Tract 22.02, District of Columbia, District of Columbia","2012",2716,1705,1705,1402,303,0,1011,178,65,116,123,291,158,98,98,81,84,42661,40553,17.8,20.4
"215","1400000US11001002301",11001002301,"Census Tract 23.01, District of Columbia, District of Columbia","2012",2470,1787,1787,1581,206,0,683,132,20,41,100,185,82,155,148,118,82,65729,40962,11.5,13.4
"216","1400000US11001002302",11001002302,"Census Tract 23.02, District of Columbia, District of Columbia","2012",1536,738,725,711,14,13,798,116,0,113,31,72,178,115,102,24,8,60898,46538,1.9,28.4
"217","1400000US11001002400",11001002400,"Census Tract 24, District of Columbia, District of Columbia","2012",3159,2294,2294,1978,316,0,865,101,0,136,110,211,121,102,191,125,140,63646,36370,13.8,14.6
"218","1400000US11001002501",11001002501,"Census Tract 25.01, District of Columbia, District of Columbia","2012",2012,1161,1161,870,291,0,851,189,120,137,82,40,60,110,68,4,118,27143,33776,25.1,37.7
"219","1400000US11001002502",11001002502,"Census Tract 25.02, District of Columbia, District of Columbia","2012",4191,2985,2985,2706,279,0,1206,136,171,185,380,239,313,192,204,110,70,41824,30755,9.3,17.8
"220","1400000US11001002600",11001002600,"Census Tract 26, District of Columbia, District of Columbia","2012",2000,1420,1420,1309,111,0,580,23,0,69,93,37,147,89,127,134,268,108472,56635,7.8,7.7
"221","1400000US11001002701",11001002701,"Census Tract 27.01, District of Columbia, District of Columbia","2012",4333,3791,3791,3536,255,0,542,243,95,143,258,380,420,238,368,282,143,52833,43691,6.7,15.9
"222","1400000US11001002702",11001002702,"Census Tract 27.02, District of Columbia, District of Columbia","2012",4632,3973,3973,3742,231,0,659,95,49,167,123,155,280,287,440,237,317,91961,49414,5.8,5.5
"223","1400000US11001002801",11001002801,"Census Tract 28.01, District of Columbia, District of Columbia","2012",3225,2320,2313,2114,199,7,905,229,65,129,155,340,332,192,205,38,33,47037,39230,8.6,23.6
"224","1400000US11001002802",11001002802,"Census Tract 28.02, District of Columbia, District of Columbia","2012",3930,3091,3091,2855,236,0,839,329,65,232,98,300,345,178,291,113,35,47721,32574,7.6,19.8
"225","1400000US11001002900",11001002900,"Census Tract 29, District of Columbia, District of Columbia","2012",3769,2949,2949,2770,179,0,820,49,51,129,196,176,222,198,218,157,147,64493,36594,6.1,14.2
"226","1400000US11001003000",11001003000,"Census Tract 30, District of Columbia, District of Columbia","2012",3036,2338,2324,2061,263,14,698,287,62,34,87,112,203,189,193,99,139,63438,44541,11.3,28.7
"227","1400000US11001003100",11001003100,"Census Tract 31, District of Columbia, District of Columbia","2012",2726,2008,2008,1826,182,0,718,9,66,128,41,109,182,150,107,50,98,61750,36329,9.1,10.7
"228","1400000US11001003200",11001003200,"Census Tract 32, District of Columbia, District of Columbia","2012",4138,3125,3125,2918,207,0,1013,139,129,151,95,129,246,205,291,141,127,68750,31673,6.6,15.7
"229","1400000US11001003301",11001003301,"Census Tract 33.01, District of Columbia, District of Columbia","2012",2699,2241,2233,2048,185,8,458,62,30,27,40,101,307,237,182,234,161,88674,51297,8.3,16.8
"230","1400000US11001003302",11001003302,"Census Tract 33.02, District of Columbia, District of Columbia","2012",1808,1505,1494,1343,151,11,303,60,17,21,21,104,108,99,263,150,62,107159,53580,10.1,16.7
"231","1400000US11001003400",11001003400,"Census Tract 34, District of Columbia, District of Columbia","2012",4662,2257,2257,1942,315,0,2405,186,78,97,88,96,157,61,224,104,88,53398,10222,14,23.7
"232","1400000US11001003500",11001003500,"Census Tract 35, District of Columbia, District of Columbia","2012",3254,2146,2138,1835,303,8,1108,203,45,101,28,39,149,132,134,100,58,64183,20181,14.2,26
"233","1400000US11001003600",11001003600,"Census Tract 36, District of Columbia, District of Columbia","2012",3813,2947,2931,2772,159,16,866,164,77,119,210,243,241,208,298,65,224,60284,44248,5.4,12.9
"234","1400000US11001003700",11001003700,"Census Tract 37, District of Columbia, District of Columbia","2012",4534,3505,3505,3248,257,0,1029,292,61,222,76,389,356,321,276,128,129,55479,28250,7.3,16.4
"235","1400000US11001003800",11001003800,"Census Tract 38, District of Columbia, District of Columbia","2012",4435,3887,3863,3584,279,24,548,163,80,168,97,322,286,515,608,232,267,89853,58173,7.2,10
"236","1400000US11001003900",11001003900,"Census Tract 39, District of Columbia, District of Columbia","2012",4129,3539,3528,3252,276,11,590,181,10,79,136,266,648,467,487,235,161,76563,56312,7.8,6.8
"237","1400000US11001004001",11001004001,"Census Tract 40.01, District of Columbia, District of Columbia","2012",3243,2801,2801,2638,163,0,442,43,0,84,28,113,362,339,608,197,396,106227,75154,5.8,2.7
"238","1400000US11001004002",11001004002,"Census Tract 40.02, District of Columbia, District of Columbia","2012",2328,1998,1998,1974,24,0,330,56,16,53,41,131,317,265,326,186,209,89868,63877,1.2,3.9
"239","1400000US11001004100",11001004100,"Census Tract 41, District of Columbia, District of Columbia","2012",2521,1959,1951,1831,120,8,562,42,30,57,26,72,235,240,301,102,372,107734,60783,6.2,6.1
"240","1400000US11001004201",11001004201,"Census Tract 42.01, District of Columbia, District of Columbia","2012",3345,3035,3035,2949,86,0,310,120,35,44,20,166,425,337,521,115,319,87237,63311,2.8,9.9
"241","1400000US11001004202",11001004202,"Census Tract 42.02, District of Columbia, District of Columbia","2012",2453,2055,2045,1982,63,10,398,72,40,31,110,142,370,196,256,146,293,82594,66721,3.1,7.6
"242","1400000US11001004300",11001004300,"Census Tract 43, District of Columbia, District of Columbia","2012",2643,2212,2198,2097,101,14,431,161,40,104,160,232,208,298,257,164,216,75625,58026,4.6,7.1
"243","1400000US11001004400",11001004400,"Census Tract 44, District of Columbia, District of Columbia","2012",5013,4383,4337,4057,280,46,630,148,130,75,38,230,237,264,577,287,483,105635,61897,6.5,15.6
"244","1400000US11001004600",11001004600,"Census Tract 46, District of Columbia, District of Columbia","2012",2226,1705,1705,1606,99,0,521,111,33,38,188,82,141,174,247,112,58,74643,49087,5.8,9.7
"245","1400000US11001004701",11001004701,"Census Tract 47.01, District of Columbia, District of Columbia","2012",2479,1506,1475,1187,288,31,973,484,210,127,94,268,57,106,112,108,111,26122,42167,19.5,30.7
"246","1400000US11001004702",11001004702,"Census Tract 47.02, District of Columbia, District of Columbia","2012",1659,1176,1142,926,216,34,483,124,54,44,100,111,135,108,214,106,73,72607,58056,18.9,17.3
"247","1400000US11001004801",11001004801,"Census Tract 48.01, District of Columbia, District of Columbia","2012",1948,1442,1442,1376,66,0,506,58,59,133,17,76,82,168,264,70,112,84875,48983,4.6,12.1
"248","1400000US11001004802",11001004802,"Census Tract 48.02, District of Columbia, District of Columbia","2012",2647,1950,1950,1796,154,0,697,150,86,55,123,258,77,134,273,114,145,61417,48083,7.9,20.3
"249","1400000US11001004901",11001004901,"Census Tract 49.01, District of Columbia, District of Columbia","2012",1909,1427,1402,1278,124,25,482,157,35,160,61,74,125,78,99,87,127,54010,54316,8.8,21.2
"250","1400000US11001004902",11001004902,"Census Tract 49.02, District of Columbia, District of Columbia","2012",2433,2198,2144,2033,111,54,235,45,16,83,131,212,86,148,170,171,312,94375,51713,5.2,10.2
"251","1400000US11001005001",11001005001,"Census Tract 50.01, District of Columbia, District of Columbia","2012",1717,1447,1447,1420,27,0,270,12,0,25,58,50,78,95,203,128,211,127828,63312,1.9,8.9
"252","1400000US11001005002",11001005002,"Census Tract 50.02, District of Columbia, District of Columbia","2012",5780,4519,4441,4086,355,78,1261,102,236,230,176,454,471,364,751,312,305,76175,56379,8,11.1
"253","1400000US11001005201",11001005201,"Census Tract 52.01, District of Columbia, District of Columbia","2012",5224,4478,4430,4336,94,48,746,273,208,127,216,401,723,376,721,272,708,78438,67398,2.1,8.9
"254","1400000US11001005301",11001005301,"Census Tract 53.01, District of Columbia, District of Columbia","2012",5098,4272,4243,4136,107,29,826,192,41,90,181,280,631,458,531,520,529,92771,68170,2.5,8.6
"255","1400000US11001005500",11001005500,"Census Tract 55, District of Columbia, District of Columbia","2012",6352,4942,4850,4699,151,92,1410,219,53,189,202,250,506,655,891,247,836,97596,77739,3.1,12.1
"256","1400000US11001005600",11001005600,"Census Tract 56, District of Columbia, District of Columbia","2012",6014,3033,3033,2966,67,0,2981,707,140,202,137,351,363,377,537,171,590,64446,54583,2.2,25
"257","1400000US11001005800",11001005800,"Census Tract 58, District of Columbia, District of Columbia","2012",2552,2126,2098,2062,36,28,426,88,26,5,93,96,170,196,345,296,373,123500,88750,1.7,6.8
"258","1400000US11001005900",11001005900,"Census Tract 59, District of Columbia, District of Columbia","2012",3346,2397,2397,2109,288,0,949,102,100,67,79,100,163,241,245,151,158,84375,42661,12,28.5
"259","1400000US11001006202",11001006202,"Census Tract 62.02, District of Columbia, District of Columbia","2012",0,0,0,0,0,0,0,0,0,0,0,0,0,0,0,0,0,NA,NA,NA,NA
"260","1400000US11001006400",11001006400,"Census Tract 64, District of Columbia, District of Columbia","2012",1330,712,712,609,103,0,618,227,83,214,54,123,84,46,56,15,0,22599,25448,14.5,33.9
"261","1400000US11001006500",11001006500,"Census Tract 65, District of Columbia, District of Columbia","2012",2349,1966,1956,1884,72,10,383,6,19,21,100,44,90,212,278,210,345,140243,78358,3.7,3.9
"262","1400000US11001006600",11001006600,"Census Tract 66, District of Columbia, District of Columbia","2012",1687,1364,1364,1353,11,0,323,25,0,9,28,90,77,71,184,163,282,139250,95833,0.8,5
"263","1400000US11001006700",11001006700,"Census Tract 67, District of Columbia, District of Columbia","2012",3624,2854,2814,2737,77,40,770,35,0,43,21,104,220,132,447,236,581,141150,83449,2.7,4.3
"264","1400000US11001006801",11001006801,"Census Tract 68.01, District of Columbia, District of Columbia","2012",1796,1358,1337,1199,138,21,438,53,20,68,45,97,78,136,171,109,67,89265,48650,10.3,12.1
"265","1400000US11001006802",11001006802,"Census Tract 68.02, District of Columbia, District of Columbia","2012",1892,1392,1388,1311,77,4,500,37,8,66,38,98,83,77,249,121,116,103114,55977,5.5,8.7
"266","1400000US11001006804",11001006804,"Census Tract 68.04, District of Columbia, District of Columbia","2012",2769,14,14,6,8,0,2755,0,0,0,0,0,0,0,0,0,0,NA,4779,57.1,93.5
"267","1400000US11001006900",11001006900,"Census Tract 69, District of Columbia, District of Columbia","2012",2025,1611,1598,1502,96,13,414,47,52,20,30,84,211,89,319,101,204,115139,61892,6,4.8
"268","1400000US11001007000",11001007000,"Census Tract 70, District of Columbia, District of Columbia","2012",2388,1994,1659,1611,48,335,394,57,35,43,9,15,183,215,199,177,233,110192,63560,2.9,6.1
"269","1400000US11001007100",11001007100,"Census Tract 71, District of Columbia, District of Columbia","2012",2490,1665,1665,1392,273,0,825,265,119,19,150,72,117,125,202,132,62,55677,51659,16.4,47.3
"270","1400000US11001007200",11001007200,"Census Tract 72, District of Columbia, District of Columbia","2012",2660,2106,1917,1781,136,189,554,132,89,59,55,158,126,199,381,217,49,89181,52737,7.1,12
"271","1400000US11001007301",11001007301,"Census Tract 73.01, District of Columbia, District of Columbia","2012",2198,1782,596,559,37,1186,416,14,0,29,86,92,181,113,128,36,29,66250,29643,6.2,2
"272","1400000US11001007304",11001007304,"Census Tract 73.04, District of Columbia, District of Columbia","2012",2983,1602,1602,1156,446,0,1381,278,114,195,78,124,131,97,166,68,10,33341,28098,27.8,38
"273","1400000US11001007401",11001007401,"Census Tract 74.01, District of Columbia, District of Columbia","2012",1605,613,613,417,196,0,992,365,87,93,72,101,63,20,22,18,0,13730,14919,32,53
"274","1400000US11001007403",11001007403,"Census Tract 74.03, District of Columbia, District of Columbia","2012",2335,1241,1241,1020,221,0,1094,203,155,63,302,177,171,5,82,0,16,30000,30000,17.8,35.4
"275","1400000US11001007404",11001007404,"Census Tract 74.04, District of Columbia, District of Columbia","2012",2305,1198,1198,1019,179,0,1107,181,105,220,176,152,102,88,43,52,47,29454,38050,14.9,39
"276","1400000US11001007406",11001007406,"Census Tract 74.06, District of Columbia, District of Columbia","2012",2110,1321,1321,1024,297,0,789,210,88,161,116,216,148,66,32,0,0,29963,20087,22.5,42.5
"277","1400000US11001007407",11001007407,"Census Tract 74.07, District of Columbia, District of Columbia","2012",1820,1279,1271,1030,241,8,541,107,75,135,152,185,172,63,82,42,23,37269,34681,19,22.3
"278","1400000US11001007408",11001007408,"Census Tract 74.08, District of Columbia, District of Columbia","2012",2410,1008,1008,724,284,0,1402,306,134,163,120,84,142,37,45,0,16,18630,22284,28.2,53.8
"279","1400000US11001007409",11001007409,"Census Tract 74.09, District of Columbia, District of Columbia","2012",2472,1282,1282,1026,256,0,1190,417,152,161,223,178,148,114,119,0,0,25474,31162,20,40.6
"280","1400000US11001007502",11001007502,"Census Tract 75.02, District of Columbia, District of Columbia","2012",3642,1599,1599,1209,390,0,2043,501,175,125,153,367,153,73,56,19,28,28804,25361,24.4,47
"281","1400000US11001007503",11001007503,"Census Tract 75.03, District of Columbia, District of Columbia","2012",1799,987,979,755,224,8,812,147,96,114,107,135,172,46,37,0,0,32262,24601,22.9,40.8
"282","1400000US11001007504",11001007504,"Census Tract 75.04, District of Columbia, District of Columbia","2012",1764,894,894,764,130,0,870,223,183,162,14,143,106,109,28,7,0,18924,31080,14.5,54.4
"283","1400000US11001007601",11001007601,"Census Tract 76.01, District of Columbia, District of Columbia","2012",3507,1955,1940,1424,516,15,1552,320,72,132,141,418,288,176,147,40,70,42121,32216,26.6,18.5
"284","1400000US11001007603",11001007603,"Census Tract 76.03, District of Columbia, District of Columbia","2012",3152,2147,2147,1986,161,0,1005,98,46,169,374,375,413,190,177,165,12,48674,48750,7.5,12.6
"285","1400000US11001007604",11001007604,"Census Tract 76.04, District of Columbia, District of Columbia","2012",2994,1863,1863,1657,206,0,1131,177,65,259,109,144,366,199,237,82,44,53323,38882,11.1,14.1
"286","1400000US11001007605",11001007605,"Census Tract 76.05, District of Columbia, District of Columbia","2012",3243,1879,1879,1621,258,0,1364,221,139,194,133,317,238,246,123,6,15,42863,29457,13.7,27.8
"287","1400000US11001007703",11001007703,"Census Tract 77.03, District of Columbia, District of Columbia","2012",3886,2533,2533,2080,453,0,1353,393,247,219,238,457,268,65,216,107,9,35496,34314,17.9,26.9
"288","1400000US11001007707",11001007707,"Census Tract 77.07, District of Columbia, District of Columbia","2012",3215,2049,2049,1634,415,0,1166,99,100,170,202,162,350,153,126,70,39,50091,30965,20.3,15.8
"289","1400000US11001007708",11001007708,"Census Tract 77.08, District of Columbia, District of Columbia","2012",2041,1209,1209,835,374,0,832,272,79,108,128,190,95,119,42,0,42,27256,30920,30.9,33.5
"290","1400000US11001007709",11001007709,"Census Tract 77.09, District of Columbia, District of Columbia","2012",1348,849,849,633,216,0,499,174,94,127,119,160,146,34,64,7,12,32725,24914,25.4,19.1
"291","1400000US11001007803",11001007803,"Census Tract 78.03, District of Columbia, District of Columbia","2012",2324,1528,1528,1059,469,0,796,184,177,309,83,108,304,84,57,21,13,25000,24375,30.7,25.3
"292","1400000US11001007804",11001007804,"Census Tract 78.04, District of Columbia, District of Columbia","2012",2296,1163,1163,976,187,0,1133,139,105,192,132,159,27,122,89,77,9,29320,29800,16.1,25.7
"293","1400000US11001007806",11001007806,"Census Tract 78.06, District of Columbia, District of Columbia","2012",1778,994,994,769,225,0,784,185,56,83,76,151,73,111,29,36,64,39632,36354,22.6,21.9
"294","1400000US11001007807",11001007807,"Census Tract 78.07, District of Columbia, District of Columbia","2012",1613,817,817,682,135,0,796,219,58,212,79,110,101,52,25,8,12,21813,21956,16.5,37.4
"295","1400000US11001007808",11001007808,"Census Tract 78.08, District of Columbia, District of Columbia","2012",3066,1819,1819,1203,616,0,1247,325,101,149,46,168,168,85,117,70,61,38929,27469,33.9,37.3
"296","1400000US11001007809",11001007809,"Census Tract 78.09, District of Columbia, District of Columbia","2012",2045,1077,1077,886,191,0,968,158,190,176,93,231,139,95,49,9,0,33297,21875,17.7,29.7
"297","1400000US11001007901",11001007901,"Census Tract 79.01, District of Columbia, District of Columbia","2012",3307,2175,2171,1657,514,4,1132,278,89,308,175,169,126,145,129,135,75,33569,40321,23.7,30.9
"298","1400000US11001007903",11001007903,"Census Tract 79.03, District of Columbia, District of Columbia","2012",1301,761,740,641,99,21,540,137,34,78,63,177,86,128,44,15,0,40577,37024,13.4,22.4
"299","1400000US11001008001",11001008001,"Census Tract 80.01, District of Columbia, District of Columbia","2012",2385,1866,1849,1742,107,17,519,57,93,52,44,104,181,146,249,156,142,92500,56042,5.8,13.9
"300","1400000US11001008002",11001008002,"Census Tract 80.02, District of Columbia, District of Columbia","2012",3100,2499,2454,2245,209,45,601,60,42,93,68,105,110,289,346,168,306,102784,59006,8.5,7.1
"301","1400000US11001008100",11001008100,"Census Tract 81, District of Columbia, District of Columbia","2012",2843,2462,2462,2396,66,0,381,52,4,20,45,40,203,158,277,96,436,125518,63517,2.7,5.3
"302","1400000US11001008200",11001008200,"Census Tract 82, District of Columbia, District of Columbia","2012",2620,2138,2130,2068,62,8,482,65,0,54,127,85,217,273,233,91,363,94342,64210,2.9,7.7
"303","1400000US11001008301",11001008301,"Census Tract 83.01, District of Columbia, District of Columbia","2012",2432,2053,2053,1967,86,0,379,58,10,37,61,47,118,113,179,215,283,110875,56727,4.2,10.6
"304","1400000US11001008302",11001008302,"Census Tract 83.02, District of Columbia, District of Columbia","2012",2062,1656,1620,1611,9,36,406,13,34,33,14,66,144,189,166,123,223,108750,62569,0.6,4.8
"305","1400000US11001008402",11001008402,"Census Tract 84.02, District of Columbia, District of Columbia","2012",1986,1514,1490,1312,178,24,472,56,58,82,16,175,112,113,211,124,69,80143,46339,11.9,11.2
"306","1400000US11001008410",11001008410,"Census Tract 84.10, District of Columbia, District of Columbia","2012",1176,972,972,887,85,0,204,29,0,36,32,28,44,93,176,70,16,98750,42594,8.7,7.6
"307","1400000US11001008701",11001008701,"Census Tract 87.01, District of Columbia, District of Columbia","2012",1848,1335,1335,1158,177,0,513,78,46,18,132,139,132,114,114,50,17,52188,36017,13.3,18
"308","1400000US11001008702",11001008702,"Census Tract 87.02, District of Columbia, District of Columbia","2012",1632,1043,1043,841,202,0,589,97,58,70,44,50,74,70,177,51,5,55441,44719,19.4,19.7
"309","1400000US11001008802",11001008802,"Census Tract 88.02, District of Columbia, District of Columbia","2012",3700,2293,2261,1836,425,32,1407,252,202,237,153,252,272,183,102,85,70,39583,33560,18.8,35.8
"310","1400000US11001008803",11001008803,"Census Tract 88.03, District of Columbia, District of Columbia","2012",1817,1106,1106,919,187,0,711,113,57,74,71,10,53,57,49,0,0,24667,7298,16.9,50.5
"311","1400000US11001008804",11001008804,"Census Tract 88.04, District of Columbia, District of Columbia","2012",2448,1480,1480,1121,359,0,968,230,127,162,159,114,132,96,63,35,0,28023,23262,24.3,33.7
"312","1400000US11001008903",11001008903,"Census Tract 89.03, District of Columbia, District of Columbia","2012",2021,1495,1495,1123,372,0,526,242,153,182,147,129,243,75,27,16,0,30440,20972,24.9,29.6
"313","1400000US11001008904",11001008904,"Census Tract 89.04, District of Columbia, District of Columbia","2012",2719,1697,1686,1320,366,11,1022,357,104,280,159,124,300,61,95,35,0,26587,28684,21.7,27.2
"314","1400000US11001009000",11001009000,"Census Tract 90, District of Columbia, District of Columbia","2012",2397,1188,1188,1128,60,0,1209,398,148,221,74,134,203,174,190,51,105,35769,55365,5.1,16.5
"315","1400000US11001009102",11001009102,"Census Tract 91.02, District of Columbia, District of Columbia","2012",3583,2010,2010,1658,352,0,1573,282,202,207,139,134,297,172,184,21,7,33438,28347,17.5,28.7
"316","1400000US11001009201",11001009201,"Census Tract 92.01, District of Columbia, District of Columbia","2012",1482,972,972,794,178,0,510,65,18,33,64,60,131,78,70,32,20,54044,26667,18.3,23.1
"317","1400000US11001009203",11001009203,"Census Tract 92.03, District of Columbia, District of Columbia","2012",2230,1532,1532,1246,286,0,698,107,101,54,99,199,130,123,126,80,53,46958,42297,18.7,14.8
"318","1400000US11001009204",11001009204,"Census Tract 92.04, District of Columbia, District of Columbia","2012",1994,1223,1223,980,243,0,771,323,171,123,155,174,180,88,27,0,17,25341,24347,19.9,35.5
"319","1400000US11001009301",11001009301,"Census Tract 93.01, District of Columbia, District of Columbia","2012",2767,1884,1884,1703,181,0,883,79,34,78,15,178,163,156,268,92,141,76599,44700,9.6,16.1
"320","1400000US11001009302",11001009302,"Census Tract 93.02, District of Columbia, District of Columbia","2012",972,726,726,654,72,0,246,0,9,5,17,88,138,47,60,33,30,65931,43526,9.9,2.7
"321","1400000US11001009400",11001009400,"Census Tract 94, District of Columbia, District of Columbia","2012",3554,2429,2429,1733,696,0,1125,106,20,127,198,126,407,216,255,121,116,66500,53057,28.7,14.7
"322","1400000US11001009501",11001009501,"Census Tract 95.01, District of Columbia, District of Columbia","2012",5360,2827,2827,2542,285,0,2533,198,177,283,120,289,313,235,84,50,28,40760,11487,10.1,30.7
"323","1400000US11001009503",11001009503,"Census Tract 95.03, District of Columbia, District of Columbia","2012",2674,1526,1526,1342,184,0,1148,91,12,81,89,147,134,285,195,118,36,78571,45377,12.1,17.6
"324","1400000US11001009504",11001009504,"Census Tract 95.04, District of Columbia, District of Columbia","2012",2538,1440,1440,1124,316,0,1098,106,5,50,219,152,291,108,152,46,28,54107,37705,21.9,8.7
"325","1400000US11001009505",11001009505,"Census Tract 95.05, District of Columbia, District of Columbia","2012",2368,1437,1437,1249,188,0,931,69,61,24,45,193,220,199,235,59,0,71546,41326,13.1,9.3
"326","1400000US11001009507",11001009507,"Census Tract 95.07, District of Columbia, District of Columbia","2012",1168,575,575,535,40,0,593,55,31,34,55,158,63,66,120,9,43,48974,44358,7,11.6
"327","1400000US11001009508",11001009508,"Census Tract 95.08, District of Columbia, District of Columbia","2012",2656,1610,1610,1447,163,0,1046,167,50,144,83,226,299,210,206,41,22,53860,37944,10.1,8.5
"328","1400000US11001009509",11001009509,"Census Tract 95.09, District of Columbia, District of Columbia","2012",2649,1704,1704,1454,250,0,945,31,35,88,75,73,375,210,233,54,16,67877,37054,14.7,5.4
"329","1400000US11001009601",11001009601,"Census Tract 96.01, District of Columbia, District of Columbia","2012",1733,954,954,661,293,0,779,151,52,145,21,102,130,33,122,0,17,35754,34460,30.7,42.9
"330","1400000US11001009602",11001009602,"Census Tract 96.02, District of Columbia, District of Columbia","2012",2092,1251,1251,874,377,0,841,273,210,277,140,136,172,87,22,0,0,20773,22264,30.1,48.1
"331","1400000US11001009603",11001009603,"Census Tract 96.03, District of Columbia, District of Columbia","2012",2364,1399,1399,1158,241,0,965,183,98,207,160,223,293,161,49,34,35,40666,35262,17.2,20.8
"332","1400000US11001009604",11001009604,"Census Tract 96.04, District of Columbia, District of Columbia","2012",1813,1042,1042,877,165,0,771,85,94,118,67,196,220,70,73,54,25,45903,40174,15.8,13.1
"333","1400000US11001009700",11001009700,"Census Tract 97, District of Columbia, District of Columbia","2012",2210,1444,1407,1008,399,37,766,217,104,119,151,44,83,108,129,27,4,27008,25296,28.4,40
"334","1400000US11001009801",11001009801,"Census Tract 98.01, District of Columbia, District of Columbia","2012",1157,622,622,408,214,0,535,114,48,79,76,88,93,40,10,9,0,29276,24556,34.4,42.6
"335","1400000US11001009802",11001009802,"Census Tract 98.02, District of Columbia, District of Columbia","2012",797,485,485,341,144,0,312,106,79,87,85,61,79,9,13,0,0,23438,21513,29.7,53.1
"336","1400000US11001009803",11001009803,"Census Tract 98.03, District of Columbia, District of Columbia","2012",1984,1022,1022,678,344,0,962,232,148,210,90,143,150,87,15,9,0,18936,28646,33.7,41.3
"337","1400000US11001009804",11001009804,"Census Tract 98.04, District of Columbia, District of Columbia","2012",2014,1357,1357,1041,316,0,657,135,17,88,87,154,240,127,100,26,15,51776,32000,23.3,20.6
"338","1400000US11001009807",11001009807,"Census Tract 98.07, District of Columbia, District of Columbia","2012",2579,1655,1655,1241,414,0,924,198,61,205,168,157,385,88,85,51,0,39063,25827,25,26.4
"339","1400000US11001009810",11001009810,"Census Tract 98.10, District of Columbia, District of Columbia","2012",1514,981,981,882,99,0,533,236,88,104,216,262,76,0,16,0,14,26667,19113,10.1,37.1
"340","1400000US11001009811",11001009811,"Census Tract 98.11, District of Columbia, District of Columbia","2012",2640,1566,1566,1018,548,0,1074,462,183,222,295,315,140,77,29,0,0,24741,27036,35,44.5
"341","1400000US11001009901",11001009901,"Census Tract 99.01, District of Columbia, District of Columbia","2012",1973,1140,1140,1013,127,0,833,53,70,32,14,49,152,279,123,105,133,83934,65625,11.1,7.8
"342","1400000US11001009902",11001009902,"Census Tract 99.02, District of Columbia, District of Columbia","2012",2334,1413,1413,1077,336,0,921,73,154,122,78,152,253,159,180,37,0,53776,37669,23.8,19.3
"343","1400000US11001009903",11001009903,"Census Tract 99.03, District of Columbia, District of Columbia","2012",1093,739,731,665,66,8,354,95,14,20,35,112,236,104,0,51,0,55665,43512,9,21.2
"344","1400000US11001009904",11001009904,"Census Tract 99.04, District of Columbia, District of Columbia","2012",1141,826,826,630,196,0,315,124,80,49,82,149,79,104,33,0,0,37083,35068,23.7,29.4
"345","1400000US11001009905",11001009905,"Census Tract 99.05, District of Columbia, District of Columbia","2012",1851,1244,1244,951,293,0,607,192,57,89,134,152,239,45,59,38,13,37256,37969,23.6,26.5
"346","1400000US11001009906",11001009906,"Census Tract 99.06, District of Columbia, District of Columbia","2012",1150,691,691,595,96,0,459,53,34,67,61,135,149,67,32,0,0,40926,35139,13.9,20.9
"347","1400000US11001009907",11001009907,"Census Tract 99.07, District of Columbia, District of Columbia","2012",1764,1015,1015,795,220,0,749,303,73,172,104,129,91,100,53,6,7,23964,25337,21.7,44.4
"348","1400000US11001010100",11001010100,"Census Tract 101, District of Columbia, District of Columbia","2012",2440,1911,1899,1846,53,12,529,191,63,81,102,323,232,213,231,144,198,59333,57353,2.8,12.3
"349","1400000US11001010200",11001010200,"Census Tract 102, District of Columbia, District of Columbia","2012",2258,1763,1749,1673,76,14,495,85,12,61,84,110,256,325,216,124,192,82656,69514,4.3,9.5
"350","1400000US11001010300",11001010300,"Census Tract 103, District of Columbia, District of Columbia","2012",2891,2036,1939,1603,336,97,855,80,35,118,90,139,227,68,208,74,53,58750,27544,17.3,17.4
"351","1400000US11001010400",11001010400,"Census Tract 104, District of Columbia, District of Columbia","2012",3572,2210,2210,1645,565,0,1362,280,83,244,98,233,252,223,39,65,0,40025,29961,25.6,32.8
"352","1400000US11001010500",11001010500,"Census Tract 105, District of Columbia, District of Columbia","2012",3980,3125,3111,2889,222,14,855,277,55,156,128,321,387,341,332,244,172,67235,54828,7.1,11.8
"353","1400000US11001010600",11001010600,"Census Tract 106, District of Columbia, District of Columbia","2012",3665,2872,2862,2636,226,10,793,143,50,130,191,134,186,282,281,196,206,80888,44250,7.9,18
"354","1400000US11001010700",11001010700,"Census Tract 107, District of Columbia, District of Columbia","2012",2010,1531,1531,1445,86,0,479,248,36,26,51,131,120,170,170,138,163,79076,48208,5.6,26
"355","1400000US11001010800",11001010800,"Census Tract 108, District of Columbia, District of Columbia","2012",6471,1711,1711,1615,96,0,4760,356,90,95,23,103,108,80,79,15,4,20673,3036,5.6,57.9
"356","1400000US11001010900",11001010900,"Census Tract 109, District of Columbia, District of Columbia","2012",2606,1356,1356,975,381,0,1250,227,102,71,184,140,250,91,55,8,0,32143,28854,28.1,54.1
"357","1400000US11001011000",11001011000,"Census Tract 110, District of Columbia, District of Columbia","2012",3272,2405,2303,2153,150,102,867,71,77,103,104,182,356,425,669,129,178,90637,63277,6.5,5.4
"358","1400000US11001011100",11001011100,"Census Tract 111, District of Columbia, District of Columbia","2012",3985,2382,2382,1812,570,0,1603,146,114,119,139,188,262,234,232,136,92,58824,45174,23.9,13.6
"359","1400000US11001000100",11001000100,"Census Tract 1, District of Columbia, District of Columbia","2013",4284,3277,3277,3078,199,0,1007,86,55,49,0,140,285,180,424,337,867,146161,74688,6.1,4.5
"360","1400000US11001000201",11001000201,"Census Tract 2.01, District of Columbia, District of Columbia","2013",3909,728,728,664,64,0,3181,0,0,0,0,0,0,0,0,0,0,NA,NA,8.8,100
"361","1400000US11001000202",11001000202,"Census Tract 2.02, District of Columbia, District of Columbia","2013",4464,2450,2443,2324,119,7,2014,193,17,35,81,103,128,47,291,280,590,149375,44609,4.9,19.2
"362","1400000US11001000300",11001000300,"Census Tract 3, District of Columbia, District of Columbia","2013",5105,3861,3845,3684,161,16,1244,118,19,138,44,355,236,256,280,375,672,111289,65069,4.2,13
"363","1400000US11001000400",11001000400,"Census Tract 4, District of Columbia, District of Columbia","2013",1289,838,838,819,19,0,451,12,12,19,5,22,86,22,45,47,333,233250,86630,2.3,8.2
"364","1400000US11001000501",11001000501,"Census Tract 5.01, District of Columbia, District of Columbia","2013",3079,2551,2551,2433,118,0,528,115,19,108,91,220,271,167,540,158,265,95556,58275,4.6,10.1
"365","1400000US11001000502",11001000502,"Census Tract 5.02, District of Columbia, District of Columbia","2013",2701,2105,2105,2045,60,0,596,25,21,39,84,162,196,189,318,218,395,115216,73511,2.9,4.8
"366","1400000US11001000600",11001000600,"Census Tract 6, District of Columbia, District of Columbia","2013",3961,2669,2669,2593,76,0,1292,178,35,32,25,124,244,182,324,251,697,125921,78478,2.8,10.9
"367","1400000US11001000701",11001000701,"Census Tract 7.01, District of Columbia, District of Columbia","2013",4516,3232,3232,3066,166,0,1284,160,76,110,343,484,503,395,621,197,386,70515,55490,5.1,4.8
"368","1400000US11001000702",11001000702,"Census Tract 7.02, District of Columbia, District of Columbia","2013",3160,2669,2669,2596,73,0,491,128,56,166,65,218,646,357,455,108,54,70033,50618,2.7,7.3
"369","1400000US11001000801",11001000801,"Census Tract 8.01, District of Columbia, District of Columbia","2013",5749,3248,3248,2986,262,0,2501,286,28,12,170,100,350,229,542,225,1015,119641,62685,8.1,12.9
"370","1400000US11001000802",11001000802,"Census Tract 8.02, District of Columbia, District of Columbia","2013",2201,1476,1465,1417,48,11,725,137,7,43,48,123,158,112,168,148,377,113523,77697,3.3,13.9
"371","1400000US11001000901",11001000901,"Census Tract 9.01, District of Columbia, District of Columbia","2013",6792,2613,2613,2366,247,0,4179,89,14,44,0,60,82,71,223,173,780,201250,18028,9.5,11.5
"372","1400000US11001000902",11001000902,"Census Tract 9.02, District of Columbia, District of Columbia","2013",1626,1189,1189,1127,62,0,437,9,0,10,25,16,55,68,132,121,358,185500,88352,5.2,3.3
"373","1400000US11001001001",11001001001,"Census Tract 10.01, District of Columbia, District of Columbia","2013",6341,4345,4315,4242,73,30,1996,73,0,54,51,195,235,220,456,592,958,156786,76171,1.7,5.2
"374","1400000US11001001002",11001001002,"Census Tract 10.02, District of Columbia, District of Columbia","2013",3116,2358,2326,2247,79,32,758,278,37,89,112,114,212,136,375,257,159,84063,44750,3.4,26.8
"375","1400000US11001001100",11001001100,"Census Tract 11, District of Columbia, District of Columbia","2013",3647,2402,2402,2352,50,0,1245,58,27,55,37,222,51,171,479,201,691,129118,84961,2.1,4.8
"376","1400000US11001001200",11001001200,"Census Tract 12, District of Columbia, District of Columbia","2013",4402,3275,3275,3214,61,0,1127,117,18,64,78,190,371,317,272,295,675,105262,67486,1.9,6.8
"377","1400000US11001001301",11001001301,"Census Tract 13.01, District of Columbia, District of Columbia","2013",3693,2857,2857,2747,110,0,836,113,0,33,150,149,293,166,406,171,484,109567,56813,3.9,8.7
"378","1400000US11001001302",11001001302,"Census Tract 13.02, District of Columbia, District of Columbia","2013",7210,5708,5687,5497,190,21,1502,181,66,224,144,388,1194,626,905,444,726,83583,60693,3.3,8.9
"379","1400000US11001001401",11001001401,"Census Tract 14.01, District of Columbia, District of Columbia","2013",2697,1852,1835,1749,86,17,845,134,20,93,57,54,154,101,157,101,554,120417,90729,4.7,10.7
"380","1400000US11001001402",11001001402,"Census Tract 14.02, District of Columbia, District of Columbia","2013",2385,1635,1619,1543,76,16,750,103,28,73,100,51,153,185,126,188,389,105568,79076,4.7,8.7
"381","1400000US11001001500",11001001500,"Census Tract 15, District of Columbia, District of Columbia","2013",4677,3032,3032,2994,38,0,1645,10,53,14,11,30,109,124,295,349,1017,204333,100867,1.3,3.1
"382","1400000US11001001600",11001001600,"Census Tract 16, District of Columbia, District of Columbia","2013",3480,2223,2214,2008,206,9,1257,23,57,57,36,66,166,157,230,234,477,140688,70673,9.3,3.7
"383","1400000US11001001702",11001001702,"Census Tract 17.02, District of Columbia, District of Columbia","2013",2569,1988,1988,1793,195,0,581,43,17,53,92,97,174,181,274,173,181,98657,60434,9.8,11.4
"384","1400000US11001001803",11001001803,"Census Tract 18.03, District of Columbia, District of Columbia","2013",2888,2014,2014,1750,264,0,874,126,105,151,224,267,338,151,139,32,85,44335,27298,13.1,10.2
"385","1400000US11001001804",11001001804,"Census Tract 18.04, District of Columbia, District of Columbia","2013",4393,3076,3076,2759,317,0,1317,246,76,255,225,329,397,181,168,57,66,42476,25551,10.3,20.3
"386","1400000US11001001901",11001001901,"Census Tract 19.01, District of Columbia, District of Columbia","2013",3313,2205,2205,1963,242,0,1108,90,23,127,126,165,160,362,251,75,76,78662,41896,11,9.4
"387","1400000US11001001902",11001001902,"Census Tract 19.02, District of Columbia, District of Columbia","2013",1830,1104,1104,1000,104,0,726,28,17,89,85,119,62,87,141,106,63,74625,40000,9.4,9
"388","1400000US11001002001",11001002001,"Census Tract 20.01, District of Columbia, District of Columbia","2013",2066,1511,1511,1387,124,0,555,80,54,35,124,217,128,29,96,58,137,49006,30913,8.2,8.4
"389","1400000US11001002002",11001002002,"Census Tract 20.02, District of Columbia, District of Columbia","2013",3077,2114,2114,1819,295,0,963,148,39,175,90,108,308,152,213,90,147,59840,42446,14,16.8
"390","1400000US11001002101",11001002101,"Census Tract 21.01, District of Columbia, District of Columbia","2013",4533,3247,3247,2707,540,0,1286,148,86,313,217,290,301,202,362,82,38,45987,33625,16.6,19.2
"391","1400000US11001002102",11001002102,"Census Tract 21.02, District of Columbia, District of Columbia","2013",3998,2902,2885,2571,314,17,1096,257,48,135,263,325,362,170,371,71,59,50142,37500,10.9,19
"392","1400000US11001002201",11001002201,"Census Tract 22.01, District of Columbia, District of Columbia","2013",3058,2025,2025,1620,405,0,1033,52,27,60,100,179,193,115,206,63,66,68170,35102,20,7
"393","1400000US11001002202",11001002202,"Census Tract 22.02, District of Columbia, District of Columbia","2013",2779,1936,1936,1545,391,0,843,193,94,140,128,217,183,68,130,76,118,41875,36719,20.2,23.6
"394","1400000US11001002301",11001002301,"Census Tract 23.01, District of Columbia, District of Columbia","2013",2454,1662,1662,1468,194,0,792,130,10,42,74,185,111,100,190,111,94,66509,39615,11.7,14.4
"395","1400000US11001002302",11001002302,"Census Tract 23.02, District of Columbia, District of Columbia","2013",1708,777,777,773,4,0,931,136,27,94,40,68,200,180,50,21,8,60263,40962,0.5,34.3
"396","1400000US11001002400",11001002400,"Census Tract 24, District of Columbia, District of Columbia","2013",3436,2572,2572,2232,340,0,864,115,0,174,122,201,119,89,270,101,151,65227,35959,13.2,12.2
"397","1400000US11001002501",11001002501,"Census Tract 25.01, District of Columbia, District of Columbia","2013",2139,1405,1405,1094,311,0,734,165,144,131,67,45,62,82,102,7,150,30694,34677,22.1,31.7
"398","1400000US11001002502",11001002502,"Census Tract 25.02, District of Columbia, District of Columbia","2013",4539,3386,3386,3098,288,0,1153,157,148,191,376,190,342,284,266,120,95,54018,33389,8.5,15.1
"399","1400000US11001002600",11001002600,"Census Tract 26, District of Columbia, District of Columbia","2013",1987,1396,1396,1283,113,0,591,19,0,63,44,58,112,83,173,143,278,126597,64138,8.1,5.8
"400","1400000US11001002701",11001002701,"Census Tract 27.01, District of Columbia, District of Columbia","2013",4262,3576,3576,3312,264,0,686,266,57,204,175,310,386,277,374,330,172,65633,50088,7.4,12.2
"401","1400000US11001002702",11001002702,"Census Tract 27.02, District of Columbia, District of Columbia","2013",5102,4337,4337,4137,200,0,765,58,27,154,92,155,383,221,406,277,407,100000,50548,4.6,4.3
"402","1400000US11001002801",11001002801,"Census Tract 28.01, District of Columbia, District of Columbia","2013",3484,2563,2557,2345,212,6,921,200,74,171,172,294,419,172,209,10,50,49232,38109,8.3,18.8
"403","1400000US11001002802",11001002802,"Census Tract 28.02, District of Columbia, District of Columbia","2013",4065,3374,3374,3136,238,0,691,292,96,251,111,319,300,166,342,117,41,46421,32946,7.1,17.4
"404","1400000US11001002900",11001002900,"Census Tract 29, District of Columbia, District of Columbia","2013",3988,3217,3217,3057,160,0,771,50,51,106,120,158,231,229,272,190,188,82120,43585,5,8.7
"405","1400000US11001003000",11001003000,"Census Tract 30, District of Columbia, District of Columbia","2013",3200,2490,2490,2241,249,0,710,272,107,56,62,145,173,155,198,121,171,63309,46105,10,26.8
"406","1400000US11001003100",11001003100,"Census Tract 31, District of Columbia, District of Columbia","2013",2738,1990,1990,1853,137,0,748,10,51,153,57,77,190,153,150,57,97,63750,40537,6.9,10.9
"407","1400000US11001003200",11001003200,"Census Tract 32, District of Columbia, District of Columbia","2013",4047,2979,2979,2772,207,0,1068,156,109,179,100,140,238,238,320,178,72,67988,35398,6.9,15.3
"408","1400000US11001003301",11001003301,"Census Tract 33.01, District of Columbia, District of Columbia","2013",2955,2453,2435,2244,191,18,502,45,47,35,52,100,248,272,177,308,147,93903,51013,7.8,14.8
"409","1400000US11001003302",11001003302,"Census Tract 33.02, District of Columbia, District of Columbia","2013",1910,1570,1566,1382,184,4,340,81,33,26,20,89,123,96,255,124,70,87393,52639,11.7,19.1
"410","1400000US11001003400",11001003400,"Census Tract 34, District of Columbia, District of Columbia","2013",4697,2333,2298,1948,350,35,2364,185,86,100,86,69,126,75,279,110,154,70263,14145,15.2,24
"411","1400000US11001003500",11001003500,"Census Tract 35, District of Columbia, District of Columbia","2013",4042,2564,2555,2203,352,9,1478,216,45,86,81,42,126,177,142,92,65,66830,15162,13.8,27.7
"412","1400000US11001003600",11001003600,"Census Tract 36, District of Columbia, District of Columbia","2013",4071,3236,3221,2903,318,15,835,105,98,70,221,249,209,302,341,113,217,75505,48628,9.9,12.8
"413","1400000US11001003700",11001003700,"Census Tract 37, District of Columbia, District of Columbia","2013",4740,3794,3794,3500,294,0,946,252,52,213,126,410,288,325,290,231,141,58663,33177,7.7,14.7
"414","1400000US11001003800",11001003800,"Census Tract 38, District of Columbia, District of Columbia","2013",4701,3999,3999,3713,286,0,702,133,115,127,155,196,319,537,602,293,344,93461,57580,7.2,9.6
"415","1400000US11001003900",11001003900,"Census Tract 39, District of Columbia, District of Columbia","2013",4397,3693,3693,3355,338,0,704,171,14,142,166,242,429,477,530,276,200,80750,57013,9.2,11.2
"416","1400000US11001004001",11001004001,"Census Tract 40.01, District of Columbia, District of Columbia","2013",3170,2679,2667,2538,129,12,491,36,0,114,15,93,471,293,526,222,387,102757,74851,4.8,2.2
"417","1400000US11001004002",11001004002,"Census Tract 40.02, District of Columbia, District of Columbia","2013",2564,2222,2222,2192,30,0,342,53,43,55,45,173,188,380,430,160,178,89675,62378,1.4,3.9
"418","1400000US11001004100",11001004100,"Census Tract 41, District of Columbia, District of Columbia","2013",2478,1894,1882,1780,102,12,584,34,29,45,25,71,210,208,336,129,350,114602,62540,5.4,6.4
"419","1400000US11001004201",11001004201,"Census Tract 42.01, District of Columbia, District of Columbia","2013",3556,3305,3305,3166,139,0,251,54,0,50,20,177,500,325,577,133,265,89851,61493,4.2,5.8
"420","1400000US11001004202",11001004202,"Census Tract 42.02, District of Columbia, District of Columbia","2013",2695,2352,2343,2289,54,9,343,65,31,60,122,127,347,177,327,171,324,90707,66844,2.3,7.3
"421","1400000US11001004300",11001004300,"Census Tract 43, District of Columbia, District of Columbia","2013",2896,2420,2404,2263,141,16,476,196,78,148,143,178,247,212,326,136,232,71021,57881,5.9,12.5
"422","1400000US11001004400",11001004400,"Census Tract 44, District of Columbia, District of Columbia","2013",5124,4435,4388,4103,285,47,689,150,86,43,12,245,185,275,648,438,472,119638,66838,6.5,14.9
"423","1400000US11001004600",11001004600,"Census Tract 46, District of Columbia, District of Columbia","2013",2371,1852,1852,1703,149,0,519,128,41,51,205,99,79,154,237,151,87,80985,46833,8,10.2
"424","1400000US11001004701",11001004701,"Census Tract 47.01, District of Columbia, District of Columbia","2013",2714,1556,1526,1361,165,30,1158,421,246,265,85,247,149,59,164,148,78,24962,42717,10.8,26.7
"425","1400000US11001004702",11001004702,"Census Tract 47.02, District of Columbia, District of Columbia","2013",1976,1543,1471,1276,195,72,433,150,63,48,60,49,141,143,223,155,111,81875,58548,13.3,16.1
"426","1400000US11001004801",11001004801,"Census Tract 48.01, District of Columbia, District of Columbia","2013",1999,1485,1485,1421,64,0,514,56,70,110,26,106,49,172,228,73,125,86629,52721,4.3,11.7
"427","1400000US11001004802",11001004802,"Census Tract 48.02, District of Columbia, District of Columbia","2013",2766,2038,2038,1910,128,0,728,148,131,77,120,219,113,160,305,113,167,61875,55417,6.3,21.8
"428","1400000US11001004901",11001004901,"Census Tract 49.01, District of Columbia, District of Columbia","2013",1926,1441,1421,1265,156,20,485,165,50,144,80,71,147,81,96,108,109,52824,52961,11,23.7
"429","1400000US11001004902",11001004902,"Census Tract 49.02, District of Columbia, District of Columbia","2013",2472,2262,2210,2050,160,52,210,69,91,46,136,187,81,107,212,177,275,93203,50915,7.2,13.8
"430","1400000US11001005001",11001005001,"Census Tract 50.01, District of Columbia, District of Columbia","2013",1889,1634,1634,1595,39,0,255,12,0,4,40,41,87,105,267,118,255,130173,66597,2.4,7.9
"431","1400000US11001005002",11001005002,"Census Tract 50.02, District of Columbia, District of Columbia","2013",5391,4391,4316,4071,245,75,1000,77,308,198,209,241,480,496,639,334,424,81316,70526,5.7,11.7
"432","1400000US11001005201",11001005201,"Census Tract 52.01, District of Columbia, District of Columbia","2013",5657,5113,5043,4885,158,70,544,261,126,128,223,391,602,422,704,453,791,92255,71484,3.1,7.8
"433","1400000US11001005301",11001005301,"Census Tract 53.01, District of Columbia, District of Columbia","2013",4940,4138,4113,4031,82,25,802,196,50,50,238,306,630,405,475,561,501,83393,71064,2,6.9
"434","1400000US11001005500",11001005500,"Census Tract 55, District of Columbia, District of Columbia","2013",6030,4562,4521,4342,179,41,1468,388,48,150,223,169,527,486,900,204,835,96793,78083,4,15.9
"435","1400000US11001005600",11001005600,"Census Tract 56, District of Columbia, District of Columbia","2013",6050,3413,3413,3279,134,0,2637,477,254,271,88,335,401,321,467,284,612,70793,54056,3.9,19.6
"436","1400000US11001005800",11001005800,"Census Tract 58, District of Columbia, District of Columbia","2013",2491,2049,2034,1994,40,15,442,139,17,13,72,101,144,158,389,275,359,118194,90153,2,11.9
"437","1400000US11001005900",11001005900,"Census Tract 59, District of Columbia, District of Columbia","2013",3104,2264,2264,2022,242,0,840,140,75,49,67,72,181,196,228,142,189,83977,44526,10.7,24.1
"438","1400000US11001006202",11001006202,"Census Tract 62.02, District of Columbia, District of Columbia","2013",0,0,0,0,0,0,0,0,0,0,0,0,0,0,0,0,0,NA,NA,NA,NA
"439","1400000US11001006400",11001006400,"Census Tract 64, District of Columbia, District of Columbia","2013",1622,802,802,646,156,0,820,268,147,199,69,133,55,50,40,19,6,20321,22742,19.5,47.8
"440","1400000US11001006500",11001006500,"Census Tract 65, District of Columbia, District of Columbia","2013",2215,1837,1826,1740,86,11,378,12,33,21,74,61,118,172,244,194,311,132794,80809,4.7,6.5
"441","1400000US11001006600",11001006600,"Census Tract 66, District of Columbia, District of Columbia","2013",1656,1346,1346,1305,41,0,310,7,0,9,32,48,64,83,179,150,294,158286,85962,3,4.2
"442","1400000US11001006700",11001006700,"Census Tract 67, District of Columbia, District of Columbia","2013",3476,2693,2673,2578,95,20,783,46,0,50,24,88,230,97,440,200,567,137143,77259,3.6,4.6
"443","1400000US11001006801",11001006801,"Census Tract 68.01, District of Columbia, District of Columbia","2013",1755,1306,1291,1114,177,15,449,55,8,73,46,88,115,110,183,89,80,85114,52857,13.7,16.2
"444","1400000US11001006802",11001006802,"Census Tract 68.02, District of Columbia, District of Columbia","2013",1811,1407,1402,1284,118,5,404,60,20,39,32,117,97,60,218,139,140,104239,70119,8.4,11.6
"445","1400000US11001006804",11001006804,"Census Tract 68.04, District of Columbia, District of Columbia","2013",2958,25,25,6,19,0,2933,0,0,0,0,0,0,0,0,0,0,NA,6177,76,94.5
"446","1400000US11001006900",11001006900,"Census Tract 69, District of Columbia, District of Columbia","2013",2079,1695,1686,1603,83,9,384,42,50,22,47,52,261,105,281,101,245,111667,66250,4.9,4.4
"447","1400000US11001007000",11001007000,"Census Tract 70, District of Columbia, District of Columbia","2013",2326,1932,1485,1444,41,447,394,89,24,13,10,30,241,166,208,113,241,98281,57786,2.8,9.4
"448","1400000US11001007100",11001007100,"Census Tract 71, District of Columbia, District of Columbia","2013",2584,1857,1857,1508,349,0,727,191,110,50,125,78,161,190,227,115,99,72941,59850,18.8,37.7
"449","1400000US11001007200",11001007200,"Census Tract 72, District of Columbia, District of Columbia","2013",3305,2648,2368,2210,158,280,657,128,120,111,50,177,135,244,443,291,75,91458,52917,6.7,12.5
"450","1400000US11001007301",11001007301,"Census Tract 73.01, District of Columbia, District of Columbia","2013",2184,1714,525,505,20,1189,470,26,0,28,110,99,152,146,141,39,34,72629,32077,3.8,2.9
"451","1400000US11001007304",11001007304,"Census Tract 73.04, District of Columbia, District of Columbia","2013",2905,1483,1483,1085,398,0,1422,307,110,211,68,154,121,83,105,49,19,23867,20179,26.8,43.2
"452","1400000US11001007401",11001007401,"Census Tract 74.01, District of Columbia, District of Columbia","2013",1720,684,684,509,175,0,1036,365,84,155,101,79,71,23,21,10,0,15393,16944,25.6,57.3
"453","1400000US11001007403",11001007403,"Census Tract 74.03, District of Columbia, District of Columbia","2013",2180,1275,1275,988,287,0,905,238,135,86,250,123,144,44,62,0,12,27652,25960,22.5,36.9
"454","1400000US11001007404",11001007404,"Census Tract 74.04, District of Columbia, District of Columbia","2013",2320,1246,1246,1057,189,0,1074,192,121,210,212,98,115,100,36,51,28,28347,27792,15.2,43
"455","1400000US11001007406",11001007406,"Census Tract 74.06, District of Columbia, District of Columbia","2013",2017,1174,1174,905,269,0,843,241,146,167,82,169,106,60,29,0,0,21484,17340,22.9,43.7
"456","1400000US11001007407",11001007407,"Census Tract 74.07, District of Columbia, District of Columbia","2013",1917,1277,1266,1038,228,11,640,144,34,176,191,126,212,51,97,20,43,37586,33984,18,17.8
"457","1400000US11001007408",11001007408,"Census Tract 74.08, District of Columbia, District of Columbia","2013",2206,1094,1094,859,235,0,1112,272,75,164,112,100,210,56,30,0,5,25058,26035,21.5,41.7
"458","1400000US11001007409",11001007409,"Census Tract 74.09, District of Columbia, District of Columbia","2013",2591,1329,1329,1007,322,0,1262,368,154,186,242,243,181,94,80,11,0,26862,31327,24.2,36.3
"459","1400000US11001007502",11001007502,"Census Tract 75.02, District of Columbia, District of Columbia","2013",3861,1665,1665,1143,522,0,2196,571,179,120,207,287,130,80,42,22,36,19559,25788,31.4,49.7
"460","1400000US11001007503",11001007503,"Census Tract 75.03, District of Columbia, District of Columbia","2013",1722,978,973,736,237,5,744,169,112,96,82,160,153,25,87,9,0,33512,28519,24.4,38.2
"461","1400000US11001007504",11001007504,"Census Tract 75.04, District of Columbia, District of Columbia","2013",1665,893,893,711,182,0,772,248,143,181,32,100,91,101,36,17,0,17372,26161,20.4,51.6
"462","1400000US11001007601",11001007601,"Census Tract 76.01, District of Columbia, District of Columbia","2013",3489,2050,2050,1559,491,0,1439,301,87,164,184,281,316,187,173,42,50,43256,35735,24,20.6
"463","1400000US11001007603",11001007603,"Census Tract 76.03, District of Columbia, District of Columbia","2013",2944,2000,2000,1816,184,0,944,96,68,155,243,306,426,213,188,169,15,53701,52525,9.2,16
"464","1400000US11001007604",11001007604,"Census Tract 76.04, District of Columbia, District of Columbia","2013",2977,1826,1826,1537,289,0,1151,225,81,150,111,182,388,198,150,77,44,52764,37955,15.8,17.7
"465","1400000US11001007605",11001007605,"Census Tract 76.05, District of Columbia, District of Columbia","2013",3194,1850,1850,1591,259,0,1344,236,111,217,115,268,222,221,161,6,11,42222,30763,14,30.5
"466","1400000US11001007703",11001007703,"Census Tract 77.03, District of Columbia, District of Columbia","2013",3821,2600,2600,2130,470,0,1221,409,237,278,267,423,308,65,156,104,0,31737,31154,18.1,31.2
"467","1400000US11001007707",11001007707,"Census Tract 77.07, District of Columbia, District of Columbia","2013",3267,1971,1971,1585,386,0,1296,111,37,284,172,168,356,147,110,55,63,49068,32902,19.6,20
"468","1400000US11001007708",11001007708,"Census Tract 77.08, District of Columbia, District of Columbia","2013",2094,1187,1187,685,502,0,907,288,98,102,140,212,116,84,29,12,19,26761,30417,42.3,41.3
"469","1400000US11001007709",11001007709,"Census Tract 77.09, District of Columbia, District of Columbia","2013",1465,935,935,722,213,0,530,176,115,136,88,176,178,18,34,28,4,33396,24596,22.8,25
"470","1400000US11001007803",11001007803,"Census Tract 78.03, District of Columbia, District of Columbia","2013",2434,1562,1562,1144,418,0,872,154,178,305,54,130,316,103,65,10,13,32750,30000,26.8,21.6
"471","1400000US11001007804",11001007804,"Census Tract 78.04, District of Columbia, District of Columbia","2013",2438,1228,1228,1105,123,0,1210,207,78,203,60,203,53,119,57,135,19,36484,31646,10,31.5
"472","1400000US11001007806",11001007806,"Census Tract 78.06, District of Columbia, District of Columbia","2013",1716,913,913,712,201,0,803,175,64,82,77,199,85,62,62,24,18,37755,32210,22,22.6
"473","1400000US11001007807",11001007807,"Census Tract 78.07, District of Columbia, District of Columbia","2013",1681,842,842,716,126,0,839,184,60,189,76,85,162,70,41,6,6,28854,24562,15,29.9
"474","1400000US11001007808",11001007808,"Census Tract 78.08, District of Columbia, District of Columbia","2013",3088,1842,1842,1145,697,0,1246,335,99,190,62,136,173,83,128,53,35,31037,26212,37.8,40.6
"475","1400000US11001007809",11001007809,"Census Tract 78.09, District of Columbia, District of Columbia","2013",2137,1241,1241,1016,225,0,896,191,145,137,145,200,159,98,96,6,0,34054,24056,18.1,30.2
"476","1400000US11001007901",11001007901,"Census Tract 79.01, District of Columbia, District of Columbia","2013",3420,2255,2255,1742,513,0,1165,225,57,265,201,236,192,139,162,132,38,38155,41064,22.7,25.7
"477","1400000US11001007903",11001007903,"Census Tract 79.03, District of Columbia, District of Columbia","2013",1387,897,867,744,123,30,490,107,43,55,77,194,101,74,72,22,0,42219,35925,14.2,20.5
"478","1400000US11001008001",11001008001,"Census Tract 80.01, District of Columbia, District of Columbia","2013",2420,1929,1908,1799,109,21,491,12,91,51,44,92,190,143,257,184,213,100969,64271,5.7,11.2
"479","1400000US11001008002",11001008002,"Census Tract 80.02, District of Columbia, District of Columbia","2013",3146,2581,2540,2342,198,41,565,72,42,78,58,70,131,242,385,160,306,108478,55821,7.8,8
"480","1400000US11001008100",11001008100,"Census Tract 81, District of Columbia, District of Columbia","2013",2828,2437,2428,2379,49,9,391,16,17,14,26,38,207,179,254,126,442,127179,62697,2,4
"481","1400000US11001008200",11001008200,"Census Tract 82, District of Columbia, District of Columbia","2013",2713,2194,2182,2090,92,12,519,81,0,50,79,60,235,299,205,102,351,92385,66616,4.2,8.4
"482","1400000US11001008301",11001008301,"Census Tract 83.01, District of Columbia, District of Columbia","2013",2404,2026,2018,1898,120,8,378,43,11,26,60,53,93,108,196,228,275,130536,56206,5.9,7.8
"483","1400000US11001008302",11001008302,"Census Tract 83.02, District of Columbia, District of Columbia","2013",2082,1636,1604,1578,26,32,446,12,28,33,12,74,75,194,195,129,234,116875,64375,1.6,6
"484","1400000US11001008402",11001008402,"Census Tract 84.02, District of Columbia, District of Columbia","2013",2004,1588,1549,1403,146,39,416,90,64,55,28,155,95,129,268,93,78,88516,48250,9.4,11.7
"485","1400000US11001008410",11001008410,"Census Tract 84.10, District of Columbia, District of Columbia","2013",1211,991,991,910,81,0,220,20,0,40,29,43,52,71,187,65,33,102900,48090,8.2,7.2
"486","1400000US11001008701",11001008701,"Census Tract 87.01, District of Columbia, District of Columbia","2013",2100,1537,1537,1364,173,0,563,69,17,46,125,125,138,98,124,111,19,57212,36867,11.3,15.3
"487","1400000US11001008702",11001008702,"Census Tract 87.02, District of Columbia, District of Columbia","2013",1800,1147,1147,899,248,0,653,130,61,50,26,46,118,44,168,61,12,54259,41976,21.6,19.9
"488","1400000US11001008802",11001008802,"Census Tract 88.02, District of Columbia, District of Columbia","2013",3761,2294,2294,1821,473,0,1467,277,170,246,122,178,349,229,118,52,75,39613,36667,20.6,32.7
"489","1400000US11001008803",11001008803,"Census Tract 88.03, District of Columbia, District of Columbia","2013",1765,965,965,738,227,0,800,149,67,62,39,36,36,43,49,0,0,18785,6932,23.5,52.2
"490","1400000US11001008804",11001008804,"Census Tract 88.04, District of Columbia, District of Columbia","2013",2334,1382,1362,1017,345,20,952,182,185,139,159,123,188,72,41,48,0,27441,23984,25.3,34.8
"491","1400000US11001008903",11001008903,"Census Tract 89.03, District of Columbia, District of Columbia","2013",2256,1521,1521,1190,331,0,735,224,65,271,114,131,204,184,52,19,17,34080,30138,21.8,32.9
"492","1400000US11001008904",11001008904,"Census Tract 89.04, District of Columbia, District of Columbia","2013",2788,1737,1728,1330,398,9,1051,363,118,245,137,149,216,128,125,48,0,30295,34750,23,27.1
"493","1400000US11001009000",11001009000,"Census Tract 90, District of Columbia, District of Columbia","2013",2489,1255,1255,1145,110,0,1234,353,201,222,101,104,199,186,130,90,121,31740,54484,8.8,16.3
"494","1400000US11001009102",11001009102,"Census Tract 91.02, District of Columbia, District of Columbia","2013",3667,2110,2110,1808,302,0,1557,347,158,229,136,137,304,215,203,14,14,35685,31628,14.3,30.5
"495","1400000US11001009201",11001009201,"Census Tract 92.01, District of Columbia, District of Columbia","2013",1525,994,994,773,221,0,531,31,50,39,68,76,109,68,70,27,16,50677,22188,22.2,23.7
"496","1400000US11001009203",11001009203,"Census Tract 92.03, District of Columbia, District of Columbia","2013",2191,1595,1595,1220,375,0,596,102,79,55,109,126,159,130,133,50,88,63073,38958,23.5,15.4
"497","1400000US11001009204",11001009204,"Census Tract 92.04, District of Columbia, District of Columbia","2013",2260,1442,1442,1133,309,0,818,350,205,137,130,112,280,107,30,0,15,24489,24487,21.4,38
"498","1400000US11001009301",11001009301,"Census Tract 93.01, District of Columbia, District of Columbia","2013",2835,2043,2043,1773,270,0,792,90,60,99,25,197,120,116,223,122,182,78415,47692,13.2,13.8
"499","1400000US11001009302",11001009302,"Census Tract 93.02, District of Columbia, District of Columbia","2013",919,683,683,589,94,0,236,0,10,5,30,119,115,35,60,23,38,58424,44554,13.8,3.1
"500","1400000US11001009400",11001009400,"Census Tract 94, District of Columbia, District of Columbia","2013",3710,2339,2339,1739,600,0,1371,97,26,163,137,118,375,195,270,171,95,69701,43063,25.7,15.5
"501","1400000US11001009501",11001009501,"Census Tract 95.01, District of Columbia, District of Columbia","2013",5729,3016,3016,2783,233,0,2713,180,103,183,209,283,356,269,82,69,12,45144,13028,7.7,24.2
"502","1400000US11001009503",11001009503,"Census Tract 95.03, District of Columbia, District of Columbia","2013",2778,1618,1618,1424,194,0,1160,68,45,111,88,128,112,358,156,116,38,79000,36857,12,19.4
"503","1400000US11001009504",11001009504,"Census Tract 95.04, District of Columbia, District of Columbia","2013",2575,1503,1503,1198,305,0,1072,109,14,50,190,122,301,112,203,47,70,61875,42596,20.3,10.8
"504","1400000US11001009505",11001009505,"Census Tract 95.05, District of Columbia, District of Columbia","2013",2240,1334,1334,1154,180,0,906,71,61,29,67,203,225,152,168,53,0,63661,34579,13.5,12.2
"505","1400000US11001009507",11001009507,"Census Tract 95.07, District of Columbia, District of Columbia","2013",1301,711,711,636,75,0,590,47,26,17,57,104,102,58,130,19,47,53646,40057,10.5,4.1
"506","1400000US11001009508",11001009508,"Census Tract 95.08, District of Columbia, District of Columbia","2013",2925,1884,1884,1722,162,0,1041,158,62,229,103,187,348,229,195,64,9,54500,33792,8.6,10.6
"507","1400000US11001009509",11001009509,"Census Tract 95.09, District of Columbia, District of Columbia","2013",2837,1927,1927,1427,500,0,910,56,31,63,99,66,422,245,202,22,41,62432,31327,25.9,5.5
"508","1400000US11001009601",11001009601,"Census Tract 96.01, District of Columbia, District of Columbia","2013",1701,911,911,639,272,0,790,120,53,184,61,97,155,33,66,0,15,26620,21650,29.9,43.1
"509","1400000US11001009602",11001009602,"Census Tract 96.02, District of Columbia, District of Columbia","2013",2178,1336,1336,956,380,0,842,213,230,344,222,100,100,144,25,0,0,21927,20606,28.4,40.3
"510","1400000US11001009603",11001009603,"Census Tract 96.03, District of Columbia, District of Columbia","2013",2279,1356,1356,1113,243,0,923,191,96,186,172,198,281,148,48,41,27,39268,35268,17.9,15.9
"511","1400000US11001009604",11001009604,"Census Tract 96.04, District of Columbia, District of Columbia","2013",1784,1065,1065,829,236,0,719,96,39,154,73,159,277,117,88,14,0,48641,36977,22.2,10.8
"512","1400000US11001009700",11001009700,"Census Tract 97, District of Columbia, District of Columbia","2013",2258,1332,1313,890,423,19,926,189,61,174,153,100,128,112,96,9,5,32595,29722,32.2,36.9
"513","1400000US11001009801",11001009801,"Census Tract 98.01, District of Columbia, District of Columbia","2013",1264,708,708,470,238,0,556,155,66,75,86,82,87,42,15,26,0,27100,28904,33.6,46.9
"514","1400000US11001009802",11001009802,"Census Tract 98.02, District of Columbia, District of Columbia","2013",832,518,518,357,161,0,314,114,81,54,56,61,80,33,16,5,0,25086,28750,31.1,45.1
"515","1400000US11001009803",11001009803,"Census Tract 98.03, District of Columbia, District of Columbia","2013",2104,1030,1030,689,341,0,1074,280,139,214,92,184,143,83,15,12,0,19345,27885,33.1,43.4
"516","1400000US11001009804",11001009804,"Census Tract 98.04, District of Columbia, District of Columbia","2013",1872,1240,1240,935,305,0,632,172,26,106,90,146,187,113,92,29,12,44356,35417,24.6,27.8
"517","1400000US11001009807",11001009807,"Census Tract 98.07, District of Columbia, District of Columbia","2013",2486,1388,1388,941,447,0,1098,226,60,198,164,173,318,52,114,20,21,35727,25641,32.2,33.2
"518","1400000US11001009810",11001009810,"Census Tract 98.10, District of Columbia, District of Columbia","2013",1553,1107,1107,960,147,0,446,214,73,151,168,208,177,10,14,10,11,28239,20331,13.3,32.1
"519","1400000US11001009811",11001009811,"Census Tract 98.11, District of Columbia, District of Columbia","2013",3217,1788,1788,1060,728,0,1429,449,187,211,356,248,173,30,51,0,0,25205,26719,40.7,45.1
"520","1400000US11001009901",11001009901,"Census Tract 99.01, District of Columbia, District of Columbia","2013",2064,1206,1206,1059,147,0,858,64,47,32,9,73,177,231,216,96,91,86500,60952,12.2,8.6
"521","1400000US11001009902",11001009902,"Census Tract 99.02, District of Columbia, District of Columbia","2013",2378,1395,1395,947,448,0,983,135,144,119,79,215,255,123,110,12,0,42052,26176,32.1,25.7
"522","1400000US11001009903",11001009903,"Census Tract 99.03, District of Columbia, District of Columbia","2013",1276,853,846,770,76,7,423,77,13,44,37,105,173,148,59,63,0,62219,47663,9,16.6
"523","1400000US11001009904",11001009904,"Census Tract 99.04, District of Columbia, District of Columbia","2013",1291,823,823,628,195,0,468,154,93,27,92,133,94,78,68,0,6,35478,34028,23.7,33
"524","1400000US11001009905",11001009905,"Census Tract 99.05, District of Columbia, District of Columbia","2013",1889,1274,1274,953,321,0,615,174,64,59,116,208,165,111,60,26,12,38310,36316,25.2,24.2
"525","1400000US11001009906",11001009906,"Census Tract 99.06, District of Columbia, District of Columbia","2013",1059,602,602,505,97,0,457,60,37,70,55,89,136,74,20,0,0,42240,36042,16.1,19.5
"526","1400000US11001009907",11001009907,"Census Tract 99.07, District of Columbia, District of Columbia","2013",1887,1073,1073,827,246,0,814,338,83,151,86,109,105,116,53,11,14,23607,27201,22.9,43.1
"527","1400000US11001010100",11001010100,"Census Tract 101, District of Columbia, District of Columbia","2013",2397,1843,1832,1775,57,11,554,174,65,95,121,262,208,257,306,128,177,70951,64275,3.1,12.6
"528","1400000US11001010200",11001010200,"Census Tract 102, District of Columbia, District of Columbia","2013",2364,1814,1802,1703,99,12,550,50,22,47,70,125,264,225,264,144,202,84053,67477,5.5,5.6
"529","1400000US11001010300",11001010300,"Census Tract 103, District of Columbia, District of Columbia","2013",2828,1828,1676,1377,299,152,1000,103,41,163,55,142,197,59,204,104,32,57024,32540,17.8,19.9
"530","1400000US11001010400",11001010400,"Census Tract 104, District of Columbia, District of Columbia","2013",3518,2084,2084,1608,476,0,1434,256,84,280,96,162,323,214,45,74,0,40078,30521,22.8,29.9
"531","1400000US11001010500",11001010500,"Census Tract 105, District of Columbia, District of Columbia","2013",3568,2770,2770,2591,179,0,798,237,46,153,109,256,363,356,390,246,118,71875,54728,6.5,10.2
"532","1400000US11001010600",11001010600,"Census Tract 106, District of Columbia, District of Columbia","2013",4243,3437,3427,3112,315,10,806,149,54,127,146,163,197,291,352,264,274,90027,47638,9.2,17.1
"533","1400000US11001010700",11001010700,"Census Tract 107, District of Columbia, District of Columbia","2013",1808,1309,1309,1252,57,0,499,215,21,35,46,172,127,160,137,136,103,65333,48010,4.4,22.4
"534","1400000US11001010800",11001010800,"Census Tract 108, District of Columbia, District of Columbia","2013",6615,2065,2065,1865,200,0,4550,312,24,133,74,80,118,91,54,22,5,24470,3231,9.7,51.3
"535","1400000US11001010900",11001010900,"Census Tract 109, District of Columbia, District of Columbia","2013",2955,1363,1363,841,522,0,1592,278,156,86,213,140,145,20,82,9,0,26445,15027,38.3,61.6
"536","1400000US11001011000",11001011000,"Census Tract 110, District of Columbia, District of Columbia","2013",3269,2440,2336,2194,142,104,829,51,102,84,194,199,300,454,579,95,234,82275,61607,6.1,4.1
"537","1400000US11001011100",11001011100,"Census Tract 111, District of Columbia, District of Columbia","2013",4004,2393,2393,1829,564,0,1611,180,104,141,128,197,223,171,254,115,102,55108,39560,23.6,18.3
"538","1400000US11001000100",11001000100,"Census Tract 1, District of Columbia, District of Columbia","2014",4300,3386,3386,3244,142,0,914,49,57,55,0,97,243,122,421,324,1078,170338,86354,4.2,2.4
"539","1400000US11001000201",11001000201,"Census Tract 2.01, District of Columbia, District of Columbia","2014",3844,985,985,916,69,0,2859,0,0,0,0,0,0,0,0,0,4,NA,NA,7,86.4
"540","1400000US11001000202",11001000202,"Census Tract 2.02, District of Columbia, District of Columbia","2014",4161,2235,2228,2125,103,7,1926,185,18,52,94,98,117,59,176,265,608,152256,41285,4.6,19.7
"541","1400000US11001000300",11001000300,"Census Tract 3, District of Columbia, District of Columbia","2014",5436,4314,4314,4154,160,0,1122,177,19,106,64,177,229,312,251,389,839,135045,59688,3.7,12
"542","1400000US11001000400",11001000400,"Census Tract 4, District of Columbia, District of Columbia","2014",1294,842,842,824,18,0,452,13,8,20,8,37,66,42,42,43,318,225179,84250,2.1,9.6
"543","1400000US11001000501",11001000501,"Census Tract 5.01, District of Columbia, District of Columbia","2014",3089,2555,2555,2419,136,0,534,99,35,115,76,162,264,222,474,173,332,100109,61433,5.3,10
"544","1400000US11001000502",11001000502,"Census Tract 5.02, District of Columbia, District of Columbia","2014",2775,2219,2219,2177,42,0,556,28,24,24,107,142,226,115,381,172,390,113688,70820,1.9,3.8
"545","1400000US11001000600",11001000600,"Census Tract 6, District of Columbia, District of Columbia","2014",3930,2782,2768,2712,56,14,1148,106,19,28,22,109,240,189,322,234,857,155031,88707,2,7.2
"546","1400000US11001000701",11001000701,"Census Tract 7.01, District of Columbia, District of Columbia","2014",4779,3174,3174,3035,139,0,1605,202,100,148,414,337,490,370,627,237,510,78040,58236,4.4,7.4
"547","1400000US11001000702",11001000702,"Census Tract 7.02, District of Columbia, District of Columbia","2014",3235,2652,2652,2589,63,0,583,145,49,172,71,167,600,335,537,130,43,71032,54705,2.4,8.7
"548","1400000US11001000801",11001000801,"Census Tract 8.01, District of Columbia, District of Columbia","2014",5879,3324,3324,3134,190,0,2555,213,46,54,190,111,278,211,380,356,1061,135119,64688,5.7,14.6
"549","1400000US11001000802",11001000802,"Census Tract 8.02, District of Columbia, District of Columbia","2014",2478,1639,1627,1572,55,12,839,144,35,31,34,172,179,123,184,48,408,91037,65313,3.4,15
"550","1400000US11001000901",11001000901,"Census Tract 9.01, District of Columbia, District of Columbia","2014",6888,2707,2707,2454,253,0,4181,82,19,9,0,76,78,74,165,190,868,231042,20332,9.3,12.1
"551","1400000US11001000902",11001000902,"Census Tract 9.02, District of Columbia, District of Columbia","2014",1749,1256,1256,1193,63,0,493,9,0,10,21,48,57,56,122,121,388,191607,91536,5,3.4
"552","1400000US11001001001",11001001001,"Census Tract 10.01, District of Columbia, District of Columbia","2014",6319,4068,4047,3963,84,21,2251,76,0,26,60,260,218,222,464,561,951,157621,80359,2.1,5.3
"553","1400000US11001001002",11001001002,"Census Tract 10.02, District of Columbia, District of Columbia","2014",3292,2525,2487,2355,132,38,767,286,71,86,92,116,180,144,407,286,163,90221,41618,5.3,27.5
"554","1400000US11001001100",11001001100,"Census Tract 11, District of Columbia, District of Columbia","2014",3791,2503,2503,2433,70,0,1288,85,16,58,31,204,159,170,471,201,686,123378,92554,2.8,5.6
"555","1400000US11001001200",11001001200,"Census Tract 12, District of Columbia, District of Columbia","2014",4239,3127,3127,3050,77,0,1112,96,15,98,175,85,381,345,302,279,670,101628,72216,2.5,6.9
"556","1400000US11001001301",11001001301,"Census Tract 13.01, District of Columbia, District of Columbia","2014",3634,2845,2845,2722,123,0,789,91,0,69,78,171,291,114,460,119,542,119234,57204,4.3,9.4
"557","1400000US11001001302",11001001302,"Census Tract 13.02, District of Columbia, District of Columbia","2014",7301,5842,5842,5636,206,0,1459,235,147,212,83,325,1031,529,1013,584,708,93795,60655,3.5,9.9
"558","1400000US11001001401",11001001401,"Census Tract 14.01, District of Columbia, District of Columbia","2014",2701,1878,1869,1757,112,9,823,108,0,103,78,79,143,119,200,70,537,113345,82917,6,10.9
"559","1400000US11001001402",11001001402,"Census Tract 14.02, District of Columbia, District of Columbia","2014",2517,1744,1735,1702,33,9,773,102,54,51,96,77,138,149,122,164,478,128625,80065,1.9,9
"560","1400000US11001001500",11001001500,"Census Tract 15, District of Columbia, District of Columbia","2014",4651,3124,3124,3071,53,0,1527,11,41,25,10,45,123,174,244,311,1005,200404,101325,1.7,2.6
"561","1400000US11001001600",11001001600,"Census Tract 16, District of Columbia, District of Columbia","2014",3381,2254,2245,2060,185,9,1127,14,17,40,39,52,162,207,279,193,503,136875,77330,8.2,2.9
"562","1400000US11001001702",11001001702,"Census Tract 17.02, District of Columbia, District of Columbia","2014",2608,2047,2047,1857,190,0,561,51,11,57,83,78,244,189,305,102,212,89926,59114,9.3,9.4
"563","1400000US11001001803",11001001803,"Census Tract 18.03, District of Columbia, District of Columbia","2014",3006,2169,2158,1966,192,11,837,102,105,190,200,208,301,215,129,10,145,47436,27287,8.9,10
"564","1400000US11001001804",11001001804,"Census Tract 18.04, District of Columbia, District of Columbia","2014",4466,3131,3131,2876,255,0,1335,161,42,295,228,331,361,236,230,60,91,46505,26950,8.1,13.9
"565","1400000US11001001901",11001001901,"Census Tract 19.01, District of Columbia, District of Columbia","2014",3111,2129,2129,1903,226,0,982,122,23,140,85,156,200,303,196,86,81,73295,41307,10.6,12.8
"566","1400000US11001001902",11001001902,"Census Tract 19.02, District of Columbia, District of Columbia","2014",1874,1270,1270,1163,107,0,604,26,16,59,70,73,106,89,205,100,75,89639,40893,8.4,10
"567","1400000US11001002001",11001002001,"Census Tract 20.01, District of Columbia, District of Columbia","2014",2183,1490,1485,1366,119,5,693,75,39,66,53,193,173,29,112,53,167,52455,36644,8,6.8
"568","1400000US11001002002",11001002002,"Census Tract 20.02, District of Columbia, District of Columbia","2014",3128,2236,2236,1929,307,0,892,121,26,166,118,34,295,153,273,78,140,64559,42083,13.7,15.9
"569","1400000US11001002101",11001002101,"Census Tract 21.01, District of Columbia, District of Columbia","2014",4493,3346,3346,2834,512,0,1147,245,79,309,149,314,349,224,360,73,43,47740,36616,15.3,18.2
"570","1400000US11001002102",11001002102,"Census Tract 21.02, District of Columbia, District of Columbia","2014",4058,2745,2738,2433,305,7,1313,330,51,133,252,236,333,143,335,165,77,51555,43125,11.1,23
"571","1400000US11001002201",11001002201,"Census Tract 22.01, District of Columbia, District of Columbia","2014",3089,2108,2108,1823,285,0,981,71,14,53,52,148,305,92,229,90,65,67117,38919,13.5,8.2
"572","1400000US11001002202",11001002202,"Census Tract 22.02, District of Columbia, District of Columbia","2014",3037,2034,2034,1750,284,0,1003,184,107,95,113,163,193,94,227,35,111,49944,31250,14,25.8
"573","1400000US11001002301",11001002301,"Census Tract 23.01, District of Columbia, District of Columbia","2014",2832,1971,1971,1690,281,0,861,74,28,50,72,151,185,75,178,119,156,71000,39342,14.3,15.9
"574","1400000US11001002302",11001002302,"Census Tract 23.02, District of Columbia, District of Columbia","2014",1727,752,752,709,43,0,975,154,37,75,31,69,205,185,80,33,10,61458,52669,5.7,32.4
"575","1400000US11001002400",11001002400,"Census Tract 24, District of Columbia, District of Columbia","2014",3703,2659,2659,2277,382,0,1044,98,8,94,118,154,119,144,297,141,167,91591,41319,14.4,12.7
"576","1400000US11001002501",11001002501,"Census Tract 25.01, District of Columbia, District of Columbia","2014",2353,1573,1573,1352,221,0,780,169,110,124,83,73,65,70,112,27,165,35813,35549,14,26.6
"577","1400000US11001002502",11001002502,"Census Tract 25.02, District of Columbia, District of Columbia","2014",4890,3851,3851,3576,275,0,1039,162,119,164,384,199,326,309,343,153,188,65325,35717,7.1,14
"578","1400000US11001002600",11001002600,"Census Tract 26, District of Columbia, District of Columbia","2014",2135,1488,1488,1365,123,0,647,16,0,63,48,72,124,44,178,153,302,129211,70000,8.3,3.7
"579","1400000US11001002701",11001002701,"Census Tract 27.01, District of Columbia, District of Columbia","2014",4808,3948,3948,3670,278,0,860,191,49,242,139,336,457,239,363,281,334,67181,51036,7,10.5
"580","1400000US11001002702",11001002702,"Census Tract 27.02, District of Columbia, District of Columbia","2014",5168,4296,4296,4109,187,0,872,91,33,149,121,162,460,281,383,206,394,90658,50769,4.4,7.4
"581","1400000US11001002801",11001002801,"Census Tract 28.01, District of Columbia, District of Columbia","2014",3516,2649,2644,2362,282,5,867,192,87,210,163,276,372,259,148,26,52,49296,34957,10.7,22.5
"582","1400000US11001002802",11001002802,"Census Tract 28.02, District of Columbia, District of Columbia","2014",4200,3496,3487,3307,180,9,704,244,54,246,111,268,345,254,355,93,57,55875,35350,5.2,15.2
"583","1400000US11001002900",11001002900,"Census Tract 29, District of Columbia, District of Columbia","2014",4123,3390,3390,3138,252,0,733,62,30,113,90,143,301,262,252,146,241,81815,44368,7.4,10.6
"584","1400000US11001003000",11001003000,"Census Tract 30, District of Columbia, District of Columbia","2014",3060,2291,2291,2095,196,0,769,250,126,98,34,127,172,155,207,131,187,64564,47357,8.6,26.4
"585","1400000US11001003100",11001003100,"Census Tract 31, District of Columbia, District of Columbia","2014",2808,2149,2149,2034,115,0,659,11,51,116,59,83,230,191,166,110,65,71774,40759,5.4,10.5
"586","1400000US11001003200",11001003200,"Census Tract 32, District of Columbia, District of Columbia","2014",3982,2922,2922,2648,274,0,1060,170,77,162,62,241,202,224,282,152,91,68163,34543,9.4,13.6
"587","1400000US11001003301",11001003301,"Census Tract 33.01, District of Columbia, District of Columbia","2014",3130,2713,2699,2539,160,14,417,47,51,20,57,98,303,203,144,250,293,96136,52294,5.9,10.8
"588","1400000US11001003302",11001003302,"Census Tract 33.02, District of Columbia, District of Columbia","2014",1930,1573,1567,1387,180,6,357,64,45,17,38,92,108,93,216,140,107,100395,59141,11.5,14.7
"589","1400000US11001003400",11001003400,"Census Tract 34, District of Columbia, District of Columbia","2014",4481,2246,2210,1927,283,36,2235,166,34,91,65,51,164,82,269,79,153,80789,12704,12.8,17.5
"590","1400000US11001003500",11001003500,"Census Tract 35, District of Columbia, District of Columbia","2014",4502,2597,2587,2278,309,10,1905,246,45,125,50,35,103,182,177,99,79,68995,10178,11.9,25.2
"591","1400000US11001003600",11001003600,"Census Tract 36, District of Columbia, District of Columbia","2014",4314,3628,3611,3335,276,17,686,86,55,74,191,177,227,272,355,199,326,92139,54867,7.6,10.7
"592","1400000US11001003700",11001003700,"Census Tract 37, District of Columbia, District of Columbia","2014",4796,3750,3750,3458,292,0,1046,286,66,247,130,382,183,281,313,342,170,68462,37581,7.8,17.8
"593","1400000US11001003800",11001003800,"Census Tract 38, District of Columbia, District of Columbia","2014",4776,3888,3888,3587,301,0,888,207,58,106,201,240,279,473,478,260,400,89295,55582,7.7,10.6
"594","1400000US11001003900",11001003900,"Census Tract 39, District of Columbia, District of Columbia","2014",4216,3591,3591,3310,281,0,625,215,15,144,110,229,444,503,415,244,327,82188,63157,7.8,10.3
"595","1400000US11001004001",11001004001,"Census Tract 40.01, District of Columbia, District of Columbia","2014",3612,3085,3064,2927,137,21,527,54,0,166,17,61,397,273,506,251,498,109884,70839,4.5,2.9
"596","1400000US11001004002",11001004002,"Census Tract 40.02, District of Columbia, District of Columbia","2014",2706,2336,2328,2294,34,8,370,53,42,80,39,195,168,415,478,114,195,91970,60926,1.5,3.4
"597","1400000US11001004100",11001004100,"Census Tract 41, District of Columbia, District of Columbia","2014",2398,1804,1794,1747,47,10,594,31,37,47,15,50,169,218,350,145,374,125179,71552,2.6,6
"598","1400000US11001004201",11001004201,"Census Tract 42.01, District of Columbia, District of Columbia","2014",3499,3225,3225,3136,89,0,274,53,13,53,22,82,503,344,565,160,317,97813,64037,2.8,5.7
"599","1400000US11001004202",11001004202,"Census Tract 42.02, District of Columbia, District of Columbia","2014",2627,2276,2269,2175,94,7,351,94,16,72,59,131,355,178,360,154,293,88750,69196,4.1,8.4
"600","1400000US11001004300",11001004300,"Census Tract 43, District of Columbia, District of Columbia","2014",3146,2663,2655,2547,108,8,483,124,95,148,102,147,308,215,380,199,230,81034,60328,4.1,10.1
"601","1400000US11001004400",11001004400,"Census Tract 44, District of Columbia, District of Columbia","2014",5186,4441,4441,4167,274,0,745,199,72,43,13,246,183,167,599,530,596,133269,70489,6.2,12.9
"602","1400000US11001004600",11001004600,"Census Tract 46, District of Columbia, District of Columbia","2014",2529,1872,1872,1729,143,0,657,117,43,100,121,95,108,83,253,165,127,91750,49940,7.6,14.2
"603","1400000US11001004701",11001004701,"Census Tract 47.01, District of Columbia, District of Columbia","2014",3091,1954,1954,1747,207,0,1137,464,259,368,133,175,165,126,218,206,104,25577,60051,10.6,26.2
"604","1400000US11001004702",11001004702,"Census Tract 47.02, District of Columbia, District of Columbia","2014",2110,1554,1500,1353,147,54,556,140,84,75,28,54,165,198,190,161,121,79833,63235,9.8,17.4
"605","1400000US11001004801",11001004801,"Census Tract 48.01, District of Columbia, District of Columbia","2014",1966,1483,1483,1426,57,0,483,67,73,100,28,54,26,134,250,88,138,99808,52822,3.8,11.8
"606","1400000US11001004802",11001004802,"Census Tract 48.02, District of Columbia, District of Columbia","2014",2868,2136,2136,2072,64,0,732,168,112,135,135,139,103,154,323,148,168,75125,56518,3,22.2
"607","1400000US11001004901",11001004901,"Census Tract 49.01, District of Columbia, District of Columbia","2014",2011,1494,1494,1346,148,0,517,184,48,84,90,83,129,129,66,97,115,54531,44925,9.9,25.1
"608","1400000US11001004902",11001004902,"Census Tract 49.02, District of Columbia, District of Columbia","2014",2561,2286,2236,2081,155,50,275,100,113,43,140,201,61,52,261,153,282,97813,50878,6.9,15
"609","1400000US11001005001",11001005001,"Census Tract 50.01, District of Columbia, District of Columbia","2014",1888,1546,1542,1519,23,4,342,6,10,11,51,16,77,103,286,124,273,132232,72130,1.5,6.2
"610","1400000US11001005002",11001005002,"Census Tract 50.02, District of Columbia, District of Columbia","2014",5546,4347,4347,4019,328,0,1199,224,221,293,231,251,501,527,598,312,366,76507,66107,7.5,15.8
"611","1400000US11001005201",11001005201,"Census Tract 52.01, District of Columbia, District of Columbia","2014",5745,5114,5074,4938,136,40,631,362,32,120,108,310,653,376,803,465,859,101789,75562,2.7,9
"612","1400000US11001005301",11001005301,"Census Tract 53.01, District of Columbia, District of Columbia","2014",5011,4252,4229,4195,34,23,759,248,32,13,239,288,507,462,660,452,532,95078,72510,0.8,7.8
"613","1400000US11001005500",11001005500,"Census Tract 55, District of Columbia, District of Columbia","2014",6306,4806,4768,4600,168,38,1500,443,52,157,227,134,695,545,826,308,845,90645,78944,3.5,15.9
"614","1400000US11001005600",11001005600,"Census Tract 56, District of Columbia, District of Columbia","2014",6378,3816,3816,3688,128,0,2562,508,225,286,86,330,414,269,508,347,606,70977,51451,3.4,17.5
"615","1400000US11001005800",11001005800,"Census Tract 58, District of Columbia, District of Columbia","2014",2518,2072,2022,1960,62,50,446,170,9,29,59,96,116,164,406,293,376,122500,95870,3.1,13.9
"616","1400000US11001005900",11001005900,"Census Tract 59, District of Columbia, District of Columbia","2014",2960,2286,2286,2078,208,0,674,138,39,44,69,74,161,197,326,144,202,95714,48931,9.1,18.1
"617","1400000US11001006202",11001006202,"Census Tract 62.02, District of Columbia, District of Columbia","2014",0,0,0,0,0,0,0,0,0,0,0,0,0,0,0,0,0,NA,NA,NA,NA
"618","1400000US11001006400",11001006400,"Census Tract 64, District of Columbia, District of Columbia","2014",1558,733,715,581,134,18,825,294,107,177,134,107,69,13,26,17,9,19933,24450,18.7,47
"619","1400000US11001006500",11001006500,"Census Tract 65, District of Columbia, District of Columbia","2014",2192,1843,1843,1770,73,0,349,11,12,13,99,64,129,141,220,162,307,128654,77565,4,5.5
"620","1400000US11001006600",11001006600,"Census Tract 66, District of Columbia, District of Columbia","2014",1721,1422,1422,1388,34,0,299,9,16,9,29,24,33,107,181,152,295,159659,84167,2.4,4.6
"621","1400000US11001006700",11001006700,"Census Tract 67, District of Columbia, District of Columbia","2014",3435,2777,2767,2663,104,10,658,54,0,49,14,76,194,142,460,213,585,138292,78605,3.8,4.6
"622","1400000US11001006801",11001006801,"Census Tract 68.01, District of Columbia, District of Columbia","2014",1798,1387,1370,1195,175,17,411,58,26,43,40,87,134,125,166,82,77,77348,50909,12.8,16.2
"623","1400000US11001006802",11001006802,"Census Tract 68.02, District of Columbia, District of Columbia","2014",1812,1432,1428,1263,165,4,380,57,24,46,43,110,82,66,174,131,182,105625,71959,11.6,13.2
"624","1400000US11001006804",11001006804,"Census Tract 68.04, District of Columbia, District of Columbia","2014",3008,16,16,6,10,0,2992,0,0,0,0,0,0,0,0,0,0,NA,5588,62.5,95
"625","1400000US11001006900",11001006900,"Census Tract 69, District of Columbia, District of Columbia","2014",1884,1573,1566,1512,54,7,311,69,44,58,51,50,181,87,280,125,246,114676,75145,3.4,5.7
"626","1400000US11001007000",11001007000,"Census Tract 70, District of Columbia, District of Columbia","2014",2483,2021,1607,1564,43,414,462,65,20,9,0,46,214,149,275,167,232,112371,61136,2.7,6.4
"627","1400000US11001007100",11001007100,"Census Tract 71, District of Columbia, District of Columbia","2014",2741,1713,1713,1425,288,0,1028,223,83,99,103,97,170,150,189,109,158,65195,61221,16.8,40.1
"628","1400000US11001007200",11001007200,"Census Tract 72, District of Columbia, District of Columbia","2014",3963,3315,2970,2807,163,345,648,116,124,95,41,187,167,318,520,426,118,106000,58536,5.5,10.1
"629","1400000US11001007301",11001007301,"Census Tract 73.01, District of Columbia, District of Columbia","2014",2296,1856,660,642,18,1196,440,25,0,22,133,144,129,163,143,56,37,66094,31632,2.7,3.1
"630","1400000US11001007304",11001007304,"Census Tract 73.04, District of Columbia, District of Columbia","2014",2857,1513,1513,1101,412,0,1344,313,87,203,34,176,196,103,71,33,25,26683,24786,27.2,39.1
"631","1400000US11001007401",11001007401,"Census Tract 74.01, District of Columbia, District of Columbia","2014",1602,684,684,507,177,0,918,362,92,177,105,57,60,28,13,5,0,14813,16364,25.9,60.1
"632","1400000US11001007403",11001007403,"Census Tract 74.03, District of Columbia, District of Columbia","2014",2257,1218,1218,915,303,0,1039,238,159,92,233,107,153,34,46,0,19,28149,25509,24.9,33.4
"633","1400000US11001007404",11001007404,"Census Tract 74.04, District of Columbia, District of Columbia","2014",2447,1192,1192,917,275,0,1255,198,88,246,233,110,143,86,26,49,0,28250,28955,23.1,47
"634","1400000US11001007406",11001007406,"Census Tract 74.06, District of Columbia, District of Columbia","2014",2091,1197,1197,1033,164,0,894,134,112,178,107,191,147,47,38,0,0,31331,22705,13.7,38.5
"635","1400000US11001007407",11001007407,"Census Tract 74.07, District of Columbia, District of Columbia","2014",2119,1403,1386,1113,273,17,716,192,72,134,144,176,238,88,66,12,36,39245,28099,19.7,21.6
"636","1400000US11001007408",11001007408,"Census Tract 74.08, District of Columbia, District of Columbia","2014",2390,1081,1081,840,241,0,1309,257,100,182,194,78,142,82,11,0,6,23879,26025,22.3,48.8
"637","1400000US11001007409",11001007409,"Census Tract 74.09, District of Columbia, District of Columbia","2014",2684,1411,1411,1160,251,0,1273,284,136,165,212,295,215,120,90,25,0,34000,35970,17.8,32.4
"638","1400000US11001007502",11001007502,"Census Tract 75.02, District of Columbia, District of Columbia","2014",4076,1724,1724,1154,570,0,2352,530,206,117,197,272,155,96,49,33,32,23304,26482,33.1,57
"639","1400000US11001007503",11001007503,"Census Tract 75.03, District of Columbia, District of Columbia","2014",1742,998,989,761,228,9,744,183,112,109,84,168,151,33,50,0,9,30893,24444,23.1,47.1
"640","1400000US11001007504",11001007504,"Census Tract 75.04, District of Columbia, District of Columbia","2014",1695,864,864,705,159,0,831,259,120,229,21,96,79,91,73,14,6,18529,30590,18.4,45.8
"641","1400000US11001007601",11001007601,"Census Tract 76.01, District of Columbia, District of Columbia","2014",3300,2107,2107,1668,439,0,1193,308,101,217,167,318,307,161,117,62,50,37434,35920,20.8,23.1
"642","1400000US11001007603",11001007603,"Census Tract 76.03, District of Columbia, District of Columbia","2014",3251,1962,1962,1764,198,0,1289,173,41,107,266,312,440,247,243,108,23,53897,53793,10.1,14.8
"643","1400000US11001007604",11001007604,"Census Tract 76.04, District of Columbia, District of Columbia","2014",3290,2225,2225,1948,277,0,1065,137,83,152,105,170,347,301,172,75,74,56736,37598,12.4,13.2
"644","1400000US11001007605",11001007605,"Census Tract 76.05, District of Columbia, District of Columbia","2014",3021,1911,1911,1662,249,0,1110,211,134,183,128,221,226,237,194,18,11,44489,31924,13,24.8
"645","1400000US11001007703",11001007703,"Census Tract 77.03, District of Columbia, District of Columbia","2014",3396,2117,2117,1644,473,0,1279,540,191,344,268,358,176,121,126,0,48,25180,25966,22.3,45.3
"646","1400000US11001007707",11001007707,"Census Tract 77.07, District of Columbia, District of Columbia","2014",3322,2009,2009,1606,403,0,1313,100,44,254,230,158,362,105,135,50,29,47883,32442,20.1,20.4
"647","1400000US11001007708",11001007708,"Census Tract 77.08, District of Columbia, District of Columbia","2014",2158,1193,1193,766,427,0,965,250,70,155,132,153,117,134,80,8,0,27760,31250,35.8,33.8
"648","1400000US11001007709",11001007709,"Census Tract 77.09, District of Columbia, District of Columbia","2014",1576,1010,1010,788,222,0,566,131,128,112,107,243,136,16,40,18,18,34825,24879,22,27
"649","1400000US11001007803",11001007803,"Census Tract 78.03, District of Columbia, District of Columbia","2014",2583,1606,1606,1270,336,0,977,148,151,270,70,188,278,167,55,8,15,36957,30155,20.9,21.4
"650","1400000US11001007804",11001007804,"Census Tract 78.04, District of Columbia, District of Columbia","2014",2450,1196,1196,1070,126,0,1254,181,61,117,123,120,173,110,100,87,9,39525,32282,10.5,25.7
"651","1400000US11001007806",11001007806,"Census Tract 78.06, District of Columbia, District of Columbia","2014",1734,942,942,769,173,0,792,199,87,64,83,176,88,79,49,17,23,34896,29452,18.4,23.3
"652","1400000US11001007807",11001007807,"Census Tract 78.07, District of Columbia, District of Columbia","2014",1681,904,904,764,140,0,777,124,40,266,61,89,170,54,51,18,11,32000,25298,15.5,22.8
"653","1400000US11001007808",11001007808,"Census Tract 78.08, District of Columbia, District of Columbia","2014",3103,1978,1978,1343,635,0,1125,283,54,219,75,86,223,111,131,86,47,40923,31897,32.1,32.1
"654","1400000US11001007809",11001007809,"Census Tract 78.09, District of Columbia, District of Columbia","2014",2093,1288,1288,1093,195,0,805,154,72,173,103,171,232,123,96,7,0,38819,26067,15.1,25.4
"655","1400000US11001007901",11001007901,"Census Tract 79.01, District of Columbia, District of Columbia","2014",3268,2101,2094,1662,432,7,1167,255,82,239,113,224,163,79,198,170,49,40658,44605,20.6,26.4
"656","1400000US11001007903",11001007903,"Census Tract 79.03, District of Columbia, District of Columbia","2014",1370,915,915,771,144,0,455,81,47,67,64,131,119,84,110,25,8,46638,37182,15.7,25.2
"657","1400000US11001008001",11001008001,"Census Tract 80.01, District of Columbia, District of Columbia","2014",2552,2034,2016,1896,120,18,518,17,54,40,41,109,198,110,345,157,281,112115,73920,6,5.9
"658","1400000US11001008002",11001008002,"Census Tract 80.02, District of Columbia, District of Columbia","2014",3165,2630,2594,2428,166,36,535,50,34,65,64,87,127,274,388,212,301,106429,57500,6.4,7.8
"659","1400000US11001008100",11001008100,"Census Tract 81, District of Columbia, District of Columbia","2014",2774,2376,2364,2316,48,12,398,22,16,29,14,71,218,164,284,141,413,124239,67903,2,2.8
"660","1400000US11001008200",11001008200,"Census Tract 82, District of Columbia, District of Columbia","2014",2739,2111,2097,2031,66,14,628,77,22,45,30,78,191,308,223,120,331,98036,65052,3.1,10.2
"661","1400000US11001008301",11001008301,"Census Tract 83.01, District of Columbia, District of Columbia","2014",2252,1952,1944,1849,95,8,300,30,10,13,45,40,73,111,213,186,286,143208,57389,4.9,7.6
"662","1400000US11001008302",11001008302,"Census Tract 83.02, District of Columbia, District of Columbia","2014",2116,1646,1625,1592,33,21,470,33,24,29,33,76,66,161,232,146,185,110250,60991,2,6.9
"663","1400000US11001008402",11001008402,"Census Tract 84.02, District of Columbia, District of Columbia","2014",1882,1501,1470,1336,134,31,381,95,90,44,18,162,122,163,168,78,105,74583,50121,9.1,12.2
"664","1400000US11001008410",11001008410,"Census Tract 84.10, District of Columbia, District of Columbia","2014",1239,1022,1015,961,54,7,217,17,3,31,24,36,57,62,201,56,46,107662,45052,5.3,6.1
"665","1400000US11001008701",11001008701,"Census Tract 87.01, District of Columbia, District of Columbia","2014",2210,1534,1534,1370,164,0,676,46,17,39,82,165,127,88,167,134,25,66442,40810,10.7,11.7
"666","1400000US11001008702",11001008702,"Census Tract 87.02, District of Columbia, District of Columbia","2014",1555,971,971,824,147,0,584,163,31,37,33,69,123,36,151,35,19,51211,41332,15.1,27.4
"667","1400000US11001008802",11001008802,"Census Tract 88.02, District of Columbia, District of Columbia","2014",3937,2410,2410,1953,457,0,1527,247,108,231,118,193,316,194,214,82,96,52606,38550,19,28.9
"668","1400000US11001008803",11001008803,"Census Tract 88.03, District of Columbia, District of Columbia","2014",1681,873,873,643,230,0,808,162,77,44,52,50,26,27,42,0,0,15313,5982,26.3,53.2
"669","1400000US11001008804",11001008804,"Census Tract 88.04, District of Columbia, District of Columbia","2014",2290,1373,1361,1014,347,12,917,129,170,142,110,139,217,81,64,64,6,38500,30385,25.5,29.9
"670","1400000US11001008903",11001008903,"Census Tract 89.03, District of Columbia, District of Columbia","2014",2630,1535,1535,1280,255,0,1095,232,105,226,146,144,193,282,68,7,12,34949,31115,16.6,33.4
"671","1400000US11001008904",11001008904,"Census Tract 89.04, District of Columbia, District of Columbia","2014",2687,1734,1726,1344,382,8,953,376,105,224,169,182,171,155,130,47,0,31694,34088,22.1,24.3
"672","1400000US11001009000",11001009000,"Census Tract 90, District of Columbia, District of Columbia","2014",2561,1218,1218,1079,139,0,1343,402,157,242,71,96,254,215,134,65,58,31848,50417,11.4,20.6
"673","1400000US11001009102",11001009102,"Census Tract 91.02, District of Columbia, District of Columbia","2014",3797,2322,2322,2046,276,0,1475,314,110,222,165,159,371,175,280,26,38,44043,32861,11.9,23.8
"674","1400000US11001009201",11001009201,"Census Tract 92.01, District of Columbia, District of Columbia","2014",1616,1062,1062,869,193,0,554,44,46,41,93,61,96,50,58,53,59,52279,27045,18.2,20.8
"675","1400000US11001009203",11001009203,"Census Tract 92.03, District of Columbia, District of Columbia","2014",2287,1781,1781,1406,375,0,506,126,78,39,85,88,105,146,150,71,119,68750,45727,21.1,16.8
"676","1400000US11001009204",11001009204,"Census Tract 92.04, District of Columbia, District of Columbia","2014",2266,1399,1399,1028,371,0,867,409,182,143,109,103,240,107,24,13,19,21993,25134,26.5,40.3
"677","1400000US11001009301",11001009301,"Census Tract 93.01, District of Columbia, District of Columbia","2014",2810,2000,2000,1655,345,0,810,73,44,64,60,127,211,145,206,89,150,75353,41857,17.3,12
"678","1400000US11001009302",11001009302,"Census Tract 93.02, District of Columbia, District of Columbia","2014",859,617,617,534,83,0,242,4,21,4,41,70,143,49,71,26,19,63375,44900,13.5,2.5
"679","1400000US11001009400",11001009400,"Census Tract 94, District of Columbia, District of Columbia","2014",3837,2369,2361,1677,684,8,1468,101,48,138,172,106,281,189,362,123,131,71454,41172,29,15.2
"680","1400000US11001009501",11001009501,"Census Tract 95.01, District of Columbia, District of Columbia","2014",5646,2942,2929,2680,249,13,2704,200,140,208,196,258,348,232,135,35,11,43924,13339,8.5,27.6
"681","1400000US11001009503",11001009503,"Census Tract 95.03, District of Columbia, District of Columbia","2014",2703,1514,1514,1343,171,0,1189,86,23,111,77,129,114,333,237,82,33,80179,42837,11.3,17.2
"682","1400000US11001009504",11001009504,"Census Tract 95.04, District of Columbia, District of Columbia","2014",2724,1596,1596,1316,280,0,1128,88,27,42,78,195,338,72,202,54,120,65682,45380,17.5,10.5
"683","1400000US11001009505",11001009505,"Census Tract 95.05, District of Columbia, District of Columbia","2014",2348,1374,1374,1176,198,0,974,78,74,45,71,127,237,119,262,54,34,70967,37143,14.4,11.8
"684","1400000US11001009507",11001009507,"Census Tract 95.07, District of Columbia, District of Columbia","2014",1304,786,786,642,144,0,518,41,30,17,45,99,114,89,116,19,21,53789,43409,18.3,8.3
"685","1400000US11001009508",11001009508,"Census Tract 95.08, District of Columbia, District of Columbia","2014",3042,2036,2036,1792,244,0,1006,162,49,206,66,184,402,296,154,104,9,60000,36814,12,10.8
"686","1400000US11001009509",11001009509,"Census Tract 95.09, District of Columbia, District of Columbia","2014",2833,1952,1952,1427,525,0,881,53,38,40,118,91,356,250,168,113,39,68973,40620,26.9,4
"687","1400000US11001009601",11001009601,"Census Tract 96.01, District of Columbia, District of Columbia","2014",1712,880,880,559,321,0,832,127,48,191,34,90,165,38,58,0,17,26607,24313,36.5,42.8
"688","1400000US11001009602",11001009602,"Census Tract 96.02, District of Columbia, District of Columbia","2014",2160,1326,1326,1108,218,0,834,201,238,352,262,149,115,105,32,0,0,22949,21501,16.4,40.6
"689","1400000US11001009603",11001009603,"Census Tract 96.03, District of Columbia, District of Columbia","2014",2578,1489,1489,1199,290,0,1089,227,106,159,199,200,357,127,52,22,32,39295,31782,19.5,18.2
"690","1400000US11001009604",11001009604,"Census Tract 96.04, District of Columbia, District of Columbia","2014",1772,1067,1067,883,184,0,705,80,45,159,79,138,239,127,104,14,8,49196,37168,17.2,10.3
"691","1400000US11001009700",11001009700,"Census Tract 97, District of Columbia, District of Columbia","2014",2464,1553,1529,1076,453,24,911,180,78,133,143,128,150,134,114,26,2,35833,31180,29.6,31.9
"692","1400000US11001009801",11001009801,"Census Tract 98.01, District of Columbia, District of Columbia","2014",1267,765,765,550,215,0,502,197,104,54,98,80,111,38,27,14,7,26389,25313,28.1,40.2
"693","1400000US11001009802",11001009802,"Census Tract 98.02, District of Columbia, District of Columbia","2014",1060,709,709,470,239,0,351,140,39,80,50,69,100,37,28,21,0,30658,28487,33.7,42.9
"694","1400000US11001009803",11001009803,"Census Tract 98.03, District of Columbia, District of Columbia","2014",2097,1250,1250,813,437,0,847,286,104,189,160,189,132,80,14,14,0,25500,22344,35,39.4
"695","1400000US11001009804",11001009804,"Census Tract 98.04, District of Columbia, District of Columbia","2014",1891,1401,1401,1072,329,0,490,187,31,92,86,165,156,60,161,36,7,43098,31359,23.5,27.5
"696","1400000US11001009807",11001009807,"Census Tract 98.07, District of Columbia, District of Columbia","2014",2554,1543,1543,1012,531,0,1011,217,46,181,109,227,296,58,154,14,16,39758,26782,34.4,34.1
"697","1400000US11001009810",11001009810,"Census Tract 98.10, District of Columbia, District of Columbia","2014",1645,1233,1233,958,275,0,412,256,80,130,146,193,201,7,15,20,13,28922,25402,22.3,36.8
"698","1400000US11001009811",11001009811,"Census Tract 98.11, District of Columbia, District of Columbia","2014",3401,2022,2022,1198,824,0,1379,315,210,189,429,309,131,157,43,0,0,29375,26726,40.8,35.5
"699","1400000US11001009901",11001009901,"Census Tract 99.01, District of Columbia, District of Columbia","2014",2008,1101,1101,990,111,0,907,64,16,33,28,100,158,190,219,83,85,82151,58158,10.1,5.6
"700","1400000US11001009902",11001009902,"Census Tract 99.02, District of Columbia, District of Columbia","2014",2420,1381,1381,1022,359,0,1039,125,157,79,57,256,184,123,136,43,0,42355,31454,26,20
"701","1400000US11001009903",11001009903,"Census Tract 99.03, District of Columbia, District of Columbia","2014",1392,953,944,868,76,9,439,46,11,87,29,92,194,153,62,33,0,61094,42965,8.1,19.2
"702","1400000US11001009904",11001009904,"Census Tract 99.04, District of Columbia, District of Columbia","2014",1508,981,981,764,217,0,527,198,87,56,122,149,84,66,88,14,7,33237,32627,22.1,38.1
"703","1400000US11001009905",11001009905,"Census Tract 99.05, District of Columbia, District of Columbia","2014",2145,1466,1466,1071,395,0,679,176,74,84,92,227,181,124,73,28,15,42788,34878,26.9,23.5
"704","1400000US11001009906",11001009906,"Census Tract 99.06, District of Columbia, District of Columbia","2014",1231,684,684,580,104,0,547,87,51,66,52,106,163,74,37,0,0,43929,35742,15.2,27.2
"705","1400000US11001009907",11001009907,"Census Tract 99.07, District of Columbia, District of Columbia","2014",2029,1073,1073,745,328,0,956,334,41,158,144,88,104,85,79,11,14,24831,34896,30.6,39.4
"706","1400000US11001010100",11001010100,"Census Tract 101, District of Columbia, District of Columbia","2014",2404,1850,1850,1782,68,0,554,118,97,48,98,249,226,203,448,97,180,80992,70057,3.7,14
"707","1400000US11001010200",11001010200,"Census Tract 102, District of Columbia, District of Columbia","2014",2296,1827,1814,1725,89,13,469,41,26,23,48,128,234,229,279,168,150,92917,62500,4.9,5.3
"708","1400000US11001010300",11001010300,"Census Tract 103, District of Columbia, District of Columbia","2014",2889,1955,1754,1445,309,201,934,102,48,174,34,143,182,104,202,130,36,61926,34186,17.6,20.2
"709","1400000US11001010400",11001010400,"Census Tract 104, District of Columbia, District of Columbia","2014",3658,2122,2122,1591,531,0,1536,290,109,267,119,232,270,165,73,66,0,35410,29140,25,31.9
"710","1400000US11001010500",11001010500,"Census Tract 105, District of Columbia, District of Columbia","2014",3300,2657,2657,2449,208,0,643,235,32,144,113,287,306,289,375,332,142,75938,64907,7.8,9.5
"711","1400000US11001010600",11001010600,"Census Tract 106, District of Columbia, District of Columbia","2014",4718,3774,3718,3331,387,56,944,240,50,152,137,133,265,287,350,337,268,84505,48377,10.4,21.4
"712","1400000US11001010700",11001010700,"Census Tract 107, District of Columbia, District of Columbia","2014",1858,1348,1348,1284,64,0,510,173,18,46,68,118,164,194,133,134,92,73300,42476,4.7,21.4
"713","1400000US11001010800",11001010800,"Census Tract 108, District of Columbia, District of Columbia","2014",6296,2035,2035,1849,186,0,4261,245,28,116,79,103,130,81,61,34,13,30694,3195,9.1,37
"714","1400000US11001010900",11001010900,"Census Tract 109, District of Columbia, District of Columbia","2014",3019,1616,1616,1065,551,0,1403,202,144,87,192,258,140,37,70,12,0,32092,13910,34.1,54.4
"715","1400000US11001011000",11001011000,"Census Tract 110, District of Columbia, District of Columbia","2014",3183,2429,2340,2167,173,89,754,83,49,100,259,139,276,383,492,145,253,87906,66346,7.4,3.9
"716","1400000US11001011100",11001011100,"Census Tract 111, District of Columbia, District of Columbia","2014",4199,2559,2559,2001,558,0,1640,172,79,154,118,231,188,214,195,145,170,58833,40078,21.8,18
